	ALL	1orMORE	CERO	NaN	ALL_TruePositive_query_count	1orMORE_TruePositive_query_count	CERO_FalsePositive_query_count	NaN_query_count	TruePositive	sum_TPFP	precision	TruePositive_x_sum_TPFP
EC number_count_0.0_1e-30	10933	200	1524	155405	375	33	134	10488	11133	12657	0.8795923204550842	9792.501303626452
EC number_count_0.0_1e-20	14500	285	2608	150669	506	43	226	10471	14785	17393	0.8500546196745817	12568.05755188869
EC number_count_0.0_1e-15	16116	327	3251	148368	560	47	266	10466	16443	19694	0.8349243424393217	13728.660962729766
EC number_count_0.0_1e-10	17587	366	3806	146303	626	50	311	10455	17953	21759	0.8250838733397674	14812.730778068844
EC number_count_0.0_1e-05	18297	405	4205	145155	654	54	360	10441	18702	22907	0.8164316584450169	15268.904876238705
EC number_count_0.0_0.01	18392	408	4399	144863	662	55	378	10439	18800	23199	0.8103797577481788	15235.139445665762
EC number_count_0.0_1	18422	408	4431	144801	663	55	389	10438	18830	23261	0.8095094793860969	15243.063496840205
Protein families_count_0.0_1e-30	19437	260	1747	146618	693	34	167	10466	19697	21444	0.9185319903003171	18092.324612945344
Protein families_count_0.0_1e-20	29791	329	2652	135290	1049	52	261	10436	30120	32772	0.9190772610765288	27682.607103625047
Protein families_count_0.0_1e-15	36456	351	3233	128022	1273	60	323	10415	36807	40040	0.9192557442557443	33835.04617882118
Protein families_count_0.0_1e-10	43967	409	4013	119673	1516	69	423	10383	44376	48389	0.9170679286614727	40695.80640228151
Protein families_count_0.0_1e-05	49430	417	4755	113460	1698	71	542	10340	49847	54602	0.912915277828651	45506.087853924764
Protein families_count_0.0_0.01	51383	421	5465	110793	1765	72	700	10325	51804	57269	0.9045731547608654	46860.507709231875
Protein families_count_0.0_1	51764	421	5880	109997	1776	72	856	10295	52185	58065	0.8987341772151899	46900.443037974685
OrthoDB_count_0.0_1e-30	13339	0	4388	150335	760	0	528	10485	13339	17727	0.7524679866869747	10037.170474417555
OrthoDB_count_0.0_1e-20	20891	0	8966	138205	1203	0	1102	10449	20891	29857	0.6997019124493419	14617.4726529792
OrthoDB_count_0.0_1e-15	25412	0	13325	129325	1470	0	1626	10416	25412	38737	0.656013630379224	16670.618375196842
OrthoDB_count_0.0_1e-10	29774	0	20693	117595	1689	0	2560	10346	29774	50467	0.5899696831592922	17565.757346384766
OrthoDB_count_0.0_1e-05	31849	0	32125	104088	1812	0	4148	10164	31849	63974	0.4978428736674274	15855.797683433895
OrthoDB_count_0.0_0.01	32321	0	40994	94747	1843	0	5619	9897	32321	73315	0.4408511218713769	14248.749110004774
OrthoDB_count_0.0_1	32373	0	45407	90282	1847	0	6480	9671	32373	77780	0.416212393931602	13474.04382874775
PANTHER_count_0.0_1e-30	23960	7470	1899	134733	1061	715	238	10421	31430	33329	0.9430225929370818	29639.200096012482
PANTHER_count_0.0_1e-20	37703	12158	5120	113081	1745	1228	642	10304	49861	54981	0.9068769211182045	45217.79016387479
PANTHER_count_0.0_1e-15	46404	15712	8079	97867	2183	1612	989	10188	62116	70195	0.8849063323598547	54966.84174086474
PANTHER_count_0.0_1e-10	55798	20146	13262	78856	2662	2058	1656	9988	75944	89206	0.8513328699863237	64653.62347824137
PANTHER_count_0.0_1e-05	63037	22795	20244	61986	3022	2377	2568	9676	85832	106076	0.8091556996870168	69451.45201553602
PANTHER_count_0.0_0.01	64769	23349	24951	54993	3114	2463	3210	9459	88118	113069	0.7793294360081012	68672.95124216187
PANTHER_count_0.0_1	65042	23401	26821	52798	3123	2469	3585	9314	88443	115264	0.7673080927262632	67863.0296449889
InterPro_count_0.0_1e-30	15949	17348	38	134727	870	1050	8	10421	33297	33335	0.9988600569971502	33259.04331783411
InterPro_count_0.0_1e-20	26425	28502	112	113023	1560	1833	24	10304	54927	55039	0.9979650793074002	54815.227911117574
InterPro_count_0.0_1e-15	33238	36838	322	97664	1990	2375	68	10189	70076	70398	0.9954260064206369	69755.47282593255
InterPro_count_0.0_1e-10	41892	47239	964	77967	2581	3136	244	9974	89131	90095	0.9893001831400189	88177.31462345303
InterPro_count_0.0_1e-05	48836	57387	3425	58414	3102	3965	865	9602	106223	109648	0.9687636801400846	102904.98439552021
InterPro_count_0.0_0.01	51165	61210	7527	48160	3310	4292	1897	9232	112375	119902	0.9372237327150507	105320.51696385382
InterPro_count_0.0_1	51642	62014	10445	43961	3352	4386	2691	8864	113656	124101	0.9158346830404267	104090.10673564274
Pfam_count_0.0_1e-30	24028	8195	257	135582	1067	605	29	10425	32223	32480	0.9920874384236453	31968.033528325122
Pfam_count_0.0_1e-20	39570	12112	860	115520	1842	1030	121	10320	51682	52542	0.9836321419055232	50836.07635796125
Pfam_count_0.0_1e-15	49729	15015	1642	101676	2339	1305	240	10222	64744	66386	0.9752658693097942	63142.61344259331
Pfam_count_0.0_1e-10	62285	18258	2986	84533	2960	1638	514	10063	80543	83529	0.9642519364532078	77663.74371775072
Pfam_count_0.0_1e-05	72028	20289	6277	69468	3467	1912	1196	9822	92317	98594	0.9363348682475607	86439.62603201007
Pfam_count_0.0_0.01	74984	20789	9938	62351	3648	1990	1970	9618	95773	105711	0.9059889699274437	86769.28161686107
Pfam_count_0.0_1	75550	20831	12199	59482	3692	1996	2539	9397	96381	108580	0.8876496592374287	85552.5618069626
eggNOG_count_0.0_1e-30	10317	184	1809	155752	644	39	266	10493	10501	12310	0.8530463038180341	8957.839236393176
eggNOG_count_0.0_1e-20	16476	275	3703	147608	1088	67	567	10465	16751	20454	0.8189596167008898	13718.392539356604
eggNOG_count_0.0_1e-15	20396	394	5538	141734	1340	82	872	10444	20790	26328	0.7896536007292616	16416.89835916135
eggNOG_count_0.0_1e-10	24259	438	8844	134521	1575	96	1405	10394	24697	33541	0.7363227095196924	18184.961957007843
eggNOG_count_0.0_1e-05	26267	471	14633	126691	1694	107	2252	10309	26738	41371	0.6462981315414179	17280.719441154433
eggNOG_count_0.0_0.01	26501	471	19144	121946	1709	107	3016	10190	26972	46116	0.5848729291352243	15775.192644635268
eggNOG_count_0.0_1	26506	471	21355	119730	1711	107	3434	10092	26977	48332	0.5581602251096582	15057.48839278325
EC number_count_0.05_1e-30	10933	200	1524	155405	375	33	134	10488	11133	12657	0.8795923204550842	9792.501303626452
EC number_count_0.05_1e-20	14500	285	2608	150669	506	43	226	10471	14785	17393	0.8500546196745817	12568.05755188869
EC number_count_0.05_1e-15	16116	327	3251	148368	560	47	266	10466	16443	19694	0.8349243424393217	13728.660962729766
EC number_count_0.05_1e-10	17587	366	3806	146303	626	50	311	10455	17953	21759	0.8250838733397674	14812.730778068844
EC number_count_0.05_1e-05	18297	405	4205	145155	654	54	360	10441	18702	22907	0.8164316584450169	15268.904876238705
EC number_count_0.05_0.01	18392	408	4399	144863	662	55	378	10439	18800	23199	0.8103797577481788	15235.139445665762
EC number_count_0.05_1	18422	408	4431	144801	663	55	389	10438	18830	23261	0.8095094793860969	15243.063496840205
Protein families_count_0.05_1e-30	19437	260	1747	146618	693	34	167	10466	19697	21444	0.9185319903003171	18092.324612945344
Protein families_count_0.05_1e-20	29791	329	2652	135290	1049	52	261	10436	30120	32772	0.9190772610765288	27682.607103625047
Protein families_count_0.05_1e-15	36456	351	3233	128022	1273	60	323	10415	36807	40040	0.9192557442557443	33835.04617882118
Protein families_count_0.05_1e-10	43967	409	4013	119673	1516	69	423	10383	44376	48389	0.9170679286614727	40695.80640228151
Protein families_count_0.05_1e-05	49430	417	4755	113460	1698	71	542	10340	49847	54602	0.912915277828651	45506.087853924764
Protein families_count_0.05_0.01	51383	421	5465	110793	1765	72	700	10325	51804	57269	0.9045731547608654	46860.507709231875
Protein families_count_0.05_1	51764	421	5880	109997	1776	72	856	10295	52185	58065	0.8987341772151899	46900.443037974685
OrthoDB_count_0.05_1e-30	13339	0	4388	150335	760	0	528	10485	13339	17727	0.7524679866869747	10037.170474417555
OrthoDB_count_0.05_1e-20	20891	0	8966	138205	1203	0	1102	10449	20891	29857	0.6997019124493419	14617.4726529792
OrthoDB_count_0.05_1e-15	25412	0	13325	129325	1470	0	1626	10416	25412	38737	0.656013630379224	16670.618375196842
OrthoDB_count_0.05_1e-10	29774	0	20693	117595	1689	0	2560	10346	29774	50467	0.5899696831592922	17565.757346384766
OrthoDB_count_0.05_1e-05	31849	0	32125	104088	1812	0	4148	10164	31849	63974	0.4978428736674274	15855.797683433895
OrthoDB_count_0.05_0.01	32321	0	40990	94751	1843	0	5619	9897	32321	73311	0.4408751756216666	14249.526551267887
OrthoDB_count_0.05_1	32373	0	45397	90292	1847	0	6479	9671	32373	77770	0.41626591230551624	13475.776379066478
PANTHER_count_0.05_1e-30	23960	7470	1899	134733	1061	715	238	10421	31430	33329	0.9430225929370818	29639.200096012482
PANTHER_count_0.05_1e-20	37703	12158	5120	113081	1745	1228	642	10304	49861	54981	0.9068769211182045	45217.79016387479
PANTHER_count_0.05_1e-15	46404	15712	8079	97867	2183	1612	989	10188	62116	70195	0.8849063323598547	54966.84174086474
PANTHER_count_0.05_1e-10	55798	20146	13262	78856	2662	2058	1656	9988	75944	89206	0.8513328699863237	64653.62347824137
PANTHER_count_0.05_1e-05	63037	22795	20244	61986	3022	2377	2568	9676	85832	106076	0.8091556996870168	69451.45201553602
PANTHER_count_0.05_0.01	64769	23349	24950	54994	3114	2463	3210	9459	88118	113068	0.7793363285810309	68673.55860190328
PANTHER_count_0.05_1	65042	23401	26819	52800	3123	2469	3585	9314	88443	115262	0.767321406881713	67864.20718883934
InterPro_count_0.05_1e-30	15949	17348	38	134727	870	1050	8	10421	33297	33335	0.9988600569971502	33259.04331783411
InterPro_count_0.05_1e-20	26425	28502	112	113023	1560	1833	24	10304	54927	55039	0.9979650793074002	54815.227911117574
InterPro_count_0.05_1e-15	33238	36838	322	97664	1990	2375	68	10189	70076	70398	0.9954260064206369	69755.47282593255
InterPro_count_0.05_1e-10	41892	47239	964	77967	2581	3136	244	9974	89131	90095	0.9893001831400189	88177.31462345303
InterPro_count_0.05_1e-05	48836	57387	3425	58414	3102	3965	865	9602	106223	109648	0.9687636801400846	102904.98439552021
InterPro_count_0.05_0.01	51165	61210	7526	48161	3310	4292	1897	9233	112375	119901	0.9372315493615566	105321.39535950492
InterPro_count_0.05_1	51642	62014	10439	43967	3352	4386	2690	8865	113656	124095	0.9158789636971675	104095.13949796527
Pfam_count_0.05_1e-30	24028	8195	257	135582	1067	605	29	10425	32223	32480	0.9920874384236453	31968.033528325122
Pfam_count_0.05_1e-20	39570	12112	860	115520	1842	1030	121	10320	51682	52542	0.9836321419055232	50836.07635796125
Pfam_count_0.05_1e-15	49729	15015	1642	101676	2339	1305	240	10222	64744	66386	0.9752658693097942	63142.61344259331
Pfam_count_0.05_1e-10	62285	18258	2986	84533	2960	1638	514	10063	80543	83529	0.9642519364532078	77663.74371775072
Pfam_count_0.05_1e-05	72028	20289	6277	69468	3467	1912	1196	9822	92317	98594	0.9363348682475607	86439.62603201007
Pfam_count_0.05_0.01	74984	20789	9937	62352	3648	1990	1970	9618	95773	105710	0.9059975404408287	86770.10244063949
Pfam_count_0.05_1	75550	20831	12196	59485	3692	1996	2539	9397	96381	108577	0.8876741851404993	85554.92563802647
eggNOG_count_0.05_1e-30	10317	184	1809	155752	644	39	266	10493	10501	12310	0.8530463038180341	8957.839236393176
eggNOG_count_0.05_1e-20	16476	275	3703	147608	1088	67	567	10465	16751	20454	0.8189596167008898	13718.392539356604
eggNOG_count_0.05_1e-15	20396	394	5538	141734	1340	82	872	10444	20790	26328	0.7896536007292616	16416.89835916135
eggNOG_count_0.05_1e-10	24259	438	8844	134521	1575	96	1405	10394	24697	33541	0.7363227095196924	18184.961957007843
eggNOG_count_0.05_1e-05	26267	471	14633	126691	1694	107	2252	10309	26738	41371	0.6462981315414179	17280.719441154433
eggNOG_count_0.05_0.01	26501	471	19141	121949	1709	107	3016	10190	26972	46113	0.5849109795502353	15776.218940428946
eggNOG_count_0.05_1	26506	471	21350	119735	1711	107	3434	10092	26977	48327	0.5582179733896165	15059.046268131686
EC number_count_0.1_1e-30	10933	200	1524	155405	375	33	134	10488	11133	12657	0.8795923204550842	9792.501303626452
EC number_count_0.1_1e-20	14500	285	2608	150669	506	43	226	10471	14785	17393	0.8500546196745817	12568.05755188869
EC number_count_0.1_1e-15	16115	327	3251	148369	560	47	266	10466	16442	19693	0.8349159599857817	13727.688214086224
EC number_count_0.1_1e-10	17581	366	3800	146315	626	50	311	10455	17947	21747	0.825263254701798	14810.999632133167
EC number_count_0.1_1e-05	18282	405	4174	145201	653	54	355	10444	18687	22861	0.8174183106600761	15275.095971304841
EC number_count_0.1_0.01	18369	408	4337	144948	661	55	371	10443	18777	23114	0.8123648005537769	15253.77385999827
EC number_count_0.1_1	18396	408	4362	144896	662	55	380	10443	18804	23166	0.8117068117068117	15263.334887334888
Protein families_count_0.1_1e-30	19437	260	1747	146618	693	34	167	10466	19697	21444	0.9185319903003171	18092.324612945344
Protein families_count_0.1_1e-20	29789	329	2650	135294	1049	52	260	10436	30118	32768	0.91912841796875	27682.309692382812
Protein families_count_0.1_1e-15	36454	351	3228	128029	1273	60	321	10415	36805	40033	0.9193665226188394	33837.28486498639
Protein families_count_0.1_1e-10	43945	409	3994	119714	1515	69	421	10383	44354	48348	0.9173905849259535	40689.94200380574
Protein families_count_0.1_1e-05	49372	417	4649	113624	1696	71	531	10344	49789	54438	0.9146000955215107	45537.024155920495
Protein families_count_0.1_0.01	51310	421	5233	111098	1762	72	671	10331	51731	56964	0.9081349624324134	46978.72974159118
Protein families_count_0.1_1	51691	421	5573	110377	1773	72	806	10306	52112	57685	0.9033890959521539	47077.412568258645
OrthoDB_count_0.1_1e-30	13337	0	4362	150363	760	0	525	10485	13337	17699	0.7535453980450872	10050.034973727328
OrthoDB_count_0.1_1e-20	20889	0	8899	138274	1203	0	1089	10449	20889	29788	0.7012555391432792	14648.52695716396
OrthoDB_count_0.1_1e-15	25410	0	13176	129476	1470	0	1597	10417	25410	38586	0.6585290001554968	16733.221893951173
OrthoDB_count_0.1_1e-10	29769	0	20319	117974	1689	0	2517	10353	29769	50088	0.5943339722089123	17692.72801868711
OrthoDB_count_0.1_1e-05	31844	0	30864	105354	1812	0	4045	10207	31844	62708	0.5078139950245583	16170.828857562034
OrthoDB_count_0.1_0.01	32314	0	38432	97316	1842	0	5411	10004	32314	70746	0.45676080626466514	14759.76869363639
OrthoDB_count_0.1_1	32366	0	42203	93493	1846	0	6232	9833	32366	74569	0.43404095535678366	14048.16956107766
PANTHER_count_0.1_1e-30	23954	7470	1867	134771	1061	715	235	10421	31424	33291	0.9439187768465952	29661.703643627407
PANTHER_count_0.1_1e-20	37688	12158	5031	113185	1744	1228	631	10306	49846	54877	0.9083222479362939	45276.23077063251
PANTHER_count_0.1_1e-15	46384	15703	7906	98069	2181	1609	977	10191	62087	69993	0.8870458474418871	55074.015530124445
PANTHER_count_0.1_1e-10	55737	20122	12878	79325	2658	2052	1619	10000	75859	88737	0.8548745168306343	64849.925972255085
PANTHER_count_0.1_1e-05	62940	22749	19193	63180	3017	2366	2508	9733	85689	104882	0.8170038710169524	70008.24470357163
PANTHER_count_0.1_0.01	64661	23295	23112	56994	3108	2451	3096	9568	87956	111068	0.791911261569489	69653.34692260597
PANTHER_count_0.1_1	64933	23347	24650	55132	3117	2457	3429	9468	88280	112930	0.781723191357478	69010.52333303816
InterPro_count_0.1_1e-30	15947	17322	24	134769	870	1048	5	10421	33269	33293	0.999279127744571	33245.01730093413
InterPro_count_0.1_1e-20	26421	28429	85	113127	1560	1831	17	10306	54850	54935	0.9984527168471831	54765.13151906799
InterPro_count_0.1_1e-15	33232	36687	265	97878	1990	2367	59	10191	69919	70184	0.9962242106463012	69655.00058417874
InterPro_count_0.1_1e-10	41859	46920	784	78499	2578	3120	208	9985	88779	89563	0.991246385226042	88001.86283398278
InterPro_count_0.1_1e-05	48738	56633	2743	59948	3088	3920	769	9675	105371	108114	0.9746286327395157	102697.5936603955
InterPro_count_0.1_0.01	51045	60170	5883	50964	3292	4239	1651	9407	111215	117098	0.9497600300602914	105627.56174315531
InterPro_count_0.1_1	51522	60911	8250	47379	3334	4323	2381	9156	112433	120683	0.9316390875268264	104746.97752790368
Pfam_count_0.1_1e-30	24027	8184	248	135603	1067	604	28	10425	32211	32459	0.992359592100804	31964.894821159
Pfam_count_0.1_1e-20	39557	12095	836	115574	1842	1028	115	10321	51652	52488	0.9840725499161713	50829.31534827008
Pfam_count_0.1_1e-15	49707	14982	1584	101789	2337	1303	233	10223	64689	66273	0.976098863790684	63142.85939975556
Pfam_count_0.1_1e-10	62227	18187	2813	84835	2957	1631	489	10067	80414	83227	0.9662008723130715	77696.07694618333
Pfam_count_0.1_1e-05	71920	20173	5603	70366	3464	1902	1122	9854	92093	97696	0.9426486243039633	86811.3397580249
Pfam_count_0.1_0.01	74850	20656	8516	64040	3643	1979	1805	9700	95506	104022	0.9181327026975062	87687.18190382804
Pfam_count_0.1_1	75413	20698	10376	61575	3686	1985	2337	9539	96111	106487	0.9025608759754712	86746.0283508785
eggNOG_count_0.1_1e-30	10317	184	1782	155779	644	39	263	10493	10501	12283	0.8549214361312383	8977.530000814133
eggNOG_count_0.1_1e-20	16471	275	3647	147669	1088	67	560	10465	16746	20393	0.821164124944834	13751.21443632619
eggNOG_count_0.1_1e-15	20390	394	5422	141856	1339	82	853	10444	20784	26206	0.7931008166068839	16483.807372357474
eggNOG_count_0.1_1e-10	24246	438	8548	134830	1574	96	1378	10396	24684	33232	0.7427780452575831	18334.73326913818
eggNOG_count_0.1_1e-05	26252	471	13861	127478	1693	107	2194	10325	26723	40584	0.6584614626453775	17596.065666272425
eggNOG_count_0.1_0.01	26486	471	17716	123389	1708	107	2894	10230	26957	44673	0.6034293644930943	16266.645378640342
eggNOG_count_0.1_1	26490	471	19625	121476	1710	107	3289	10151	26961	46586	0.5787361009745418	15603.30401837462
EC number_count_0.15_1e-30	10899	200	1518	155445	371	33	134	10488	11099	12617	0.8796861377506539	9763.636442894507
EC number_count_0.15_1e-20	14325	285	2554	150898	495	43	222	10471	14610	17164	0.851200186436728	12436.034723840596
EC number_count_0.15_1e-15	15877	326	3147	148712	547	46	259	10466	16203	19350	0.8373643410852714	13567.814418604652
EC number_count_0.15_1e-10	17224	364	3555	146919	607	48	293	10459	17588	21143	0.831859244194296	14630.740386889278
EC number_count_0.15_1e-05	17802	401	3704	146155	629	51	317	10456	18203	21907	0.830921623225453	15125.266307572922
EC number_count_0.15_0.01	17850	404	3778	146030	631	52	320	10456	18254	22032	0.828522149600581	15123.843318809006
EC number_count_0.15_1	17873	404	3781	146004	631	52	321	10456	18277	22058	0.8285882672953123	15144.107761356423
Protein families_count_0.15_1e-30	19277	260	1739	146786	685	34	165	10468	19537	21276	0.9182647114119196	17940.137666854673
Protein families_count_0.15_1e-20	29272	329	2576	135885	1022	52	254	10441	29601	32177	0.9199428162973553	27231.227305218013
Protein families_count_0.15_1e-15	35556	351	3091	129064	1237	60	305	10422	35907	38998	0.9207395251038515	33060.99412790399
Protein families_count_0.15_1e-10	42427	409	3607	121619	1471	69	374	10403	42836	46443	0.9223349051525526	39509.13799711474
Protein families_count_0.15_1e-05	47269	416	3864	116513	1630	71	420	10385	47685	51549	0.9250421928650411	44110.63696676948
Protein families_count_0.15_0.01	48946	420	4065	114631	1690	72	467	10380	49366	53431	0.9239205704553536	45610.262881098985
Protein families_count_0.15_1	49287	420	4178	114177	1701	72	523	10366	49707	53885	0.9224645077479818	45852.943286628935
OrthoDB_count_0.15_1e-30	13238	0	4076	150748	754	0	483	10487	13238	17314	0.7645835739863694	10121.557352431559
OrthoDB_count_0.15_1e-20	20624	0	7762	139676	1187	0	941	10456	20624	28386	0.7265553441837526	14984.477418445713
OrthoDB_count_0.15_1e-15	25022	0	10983	132057	1440	0	1320	10433	25022	36005	0.6949590334675739	17389.264935425635
OrthoDB_count_0.15_1e-10	29247	0	15509	123306	1655	0	1846	10408	29247	44756	0.6534766288318885	19112.230963446244
OrthoDB_count_0.15_1e-05	31222	0	20746	116094	1770	0	2591	10371	31222	51968	0.6007927955665024	18757.95266317734
OrthoDB_count_0.15_0.01	31675	0	23211	113176	1798	0	3128	10344	31675	54886	0.5771052727471486	18279.809514265933
OrthoDB_count_0.15_1	31726	0	24639	111697	1802	0	3632	10298	31726	56365	0.5628670274106271	17857.519311629556
PANTHER_count_0.15_1e-30	23544	7370	1730	135418	1035	697	213	10424	30914	32644	0.9470040436221051	29275.683004533756
PANTHER_count_0.15_1e-20	36539	11810	4353	115360	1679	1178	531	10327	48349	52702	0.9174035140981367	44355.54250313081
PANTHER_count_0.15_1e-15	44505	15047	6471	102039	2081	1520	773	10240	59552	66023	0.9019887009072596	53715.231116429124
PANTHER_count_0.15_1e-10	52809	18887	9358	87008	2509	1901	1158	10133	71696	81054	0.8845461050657586	63418.41754879463
PANTHER_count_0.15_1e-05	59053	20994	11986	76029	2827	2163	1614	10027	80047	92033	0.8697641063531559	69622.00742125107
PANTHER_count_0.15_0.01	60573	21402	13126	72961	2915	2231	1863	9994	81975	95101	0.8619783177884565	70660.67260070871
PANTHER_count_0.15_1	60824	21448	13593	72197	2923	2238	2038	9974	82272	95865	0.8582068533875763	70606.39424190267
InterPro_count_0.15_1e-30	15826	16831	12	135393	853	1010	4	10424	32657	32669	0.9996326792984175	32645.00440784842
InterPro_count_0.15_1e-20	25926	26841	36	115259	1501	1697	8	10328	52767	52803	0.9993182205556502	52731.02454406
InterPro_count_0.15_1e-15	32235	33838	122	101867	1894	2144	19	10241	66073	66195	0.9981569604955057	65951.22485081955
InterPro_count_0.15_1e-10	39861	41460	231	86510	2399	2695	45	10127	81321	81552	0.9971674514420247	81090.65431871689
InterPro_count_0.15_1e-05	45639	47460	472	74491	2819	3253	137	10006	93099	93571	0.9949557020871851	92629.38090861484
InterPro_count_0.15_0.01	47563	49304	957	70238	2979	3470	359	9952	96867	97824	0.9902171246319922	95919.36221172719
InterPro_count_0.15_1	47998	49759	1606	68699	3018	3545	704	9902	97757	99363	0.9838370419572678	96176.95771061664
Pfam_count_0.15_1e-30	23844	7955	227	136036	1048	583	24	10428	31799	32026	0.9929120089926934	31573.608973958657
Pfam_count_0.15_1e-20	38858	11376	689	117139	1777	958	89	10340	50234	50923	0.9864697680812207	49554.32232979204
Pfam_count_0.15_1e-15	48358	13817	1240	104647	2224	1179	163	10264	62175	63415	0.9804462666561539	60959.246629346366
Pfam_count_0.15_1e-10	59441	16277	1735	90609	2779	1428	277	10164	75718	77453	0.9775993182962571	74021.865182756
Pfam_count_0.15_1e-05	67545	17622	2496	80399	3214	1620	495	10071	85167	87663	0.9715273262379795	82742.06779371
Pfam_count_0.15_0.01	69942	17901	3172	77047	3355	1674	726	10031	87843	91015	0.9651486018788111	84781.54863484041
Pfam_count_0.15_1	70423	17926	3712	76001	3396	1679	995	9990	88349	92061	0.9596789085497659	84786.67189146327
eggNOG_count_0.15_1e-30	10126	176	1636	156124	630	37	232	10493	10302	11938	0.8629586195342603	8890.19969844195
eggNOG_count_0.15_1e-20	15965	249	3021	148827	1051	62	458	10472	16214	19235	0.8429425526384196	13667.470548479334
eggNOG_count_0.15_1e-15	19686	360	4167	143849	1289	74	658	10457	20046	24213	0.8279023664973362	16596.130838805602
eggNOG_count_0.15_1e-10	23311	398	5859	138494	1508	87	929	10434	23709	29568	0.8018465909090909	19010.980823863636
eggNOG_count_0.15_1e-05	25182	428	8427	134025	1620	97	1346	10416	25610	34037	0.7524164879395951	19269.38625613303
eggNOG_count_0.15_0.01	25391	428	9869	132374	1634	97	1640	10403	25819	35688	0.7234644698498095	18679.12914705223
eggNOG_count_0.15_1	25395	428	10598	131641	1636	97	1867	10386	25823	36421	0.7090140303670959	18308.869306169516
EC number_count_0.2_1e-30	10554	196	1419	155893	360	31	124	10494	10750	12169	0.8833922261484098	9496.466431095405
EC number_count_0.2_1e-20	13688	268	2331	151775	475	40	201	10482	13956	16287	0.8568797200221036	11958.613372628477
EC number_count_0.2_1e-15	14941	306	2728	150087	514	42	227	10481	15247	17975	0.8482336578581363	12933.018581363005
EC number_count_0.2_1e-10	15947	330	2869	148916	560	43	238	10475	16277	19146	0.8501514676694871	13837.915439256241
EC number_count_0.2_1e-05	16337	363	2916	148446	577	45	244	10473	16700	19616	0.8513458401305057	14217.475530179447
EC number_count_0.2_0.01	16363	363	2945	148391	578	45	245	10473	16726	19671	0.8502872248487622	14221.904122820397
EC number_count_0.2_1	16386	363	2945	148368	578	45	245	10473	16749	19694	0.8504620696658881	14244.38920483396
Protein families_count_0.2_1e-30	18398	260	1656	147748	650	34	153	10480	18658	20314	0.9184798661021956	17136.997341734765
Protein families_count_0.2_1e-20	27172	321	2380	138189	941	50	228	10458	27493	29873	0.9203293944364477	25302.616041241257
Protein families_count_0.2_1e-15	32191	341	2736	132794	1108	57	259	10448	32532	35268	0.9224225927186118	30008.251786321878
Protein families_count_0.2_1e-10	37500	377	2950	127235	1302	61	292	10434	37877	40827	0.9277438949714649	35140.15550983418
Protein families_count_0.2_1e-05	41085	383	3005	123589	1433	62	303	10423	41468	44473	0.9324309131383086	38666.04510601938
Protein families_count_0.2_0.01	42221	387	3088	122366	1480	63	322	10420	42608	45696	0.9324229691876751	39728.67787114846
Protein families_count_0.2_1	42456	387	3114	122105	1491	63	334	10414	42843	45957	0.9322410078986879	39940.00150140349
OrthoDB_count_0.2_1e-30	12440	0	3505	152117	703	0	413	10493	12440	15945	0.7801818751959863	9705.462527438069
OrthoDB_count_0.2_1e-20	19057	0	5654	143351	1078	0	704	10468	19057	24711	0.7711950143660717	14696.66338877423
OrthoDB_count_0.2_1e-15	22825	0	7289	137948	1302	0	917	10458	22825	30114	0.7579531115095969	17300.279770206547
OrthoDB_count_0.2_1e-10	26365	0	9494	132203	1486	0	1199	10445	26365	35859	0.7352408042611339	19384.623804344796
OrthoDB_count_0.2_1e-05	28041	0	11957	128064	1581	0	1510	10439	28041	39998	0.7010600530026502	19658.424946247313
OrthoDB_count_0.2_0.01	28415	0	12861	126786	1604	0	1651	10435	28415	41276	0.6884145750557225	19561.300150208353
OrthoDB_count_0.2_1	28461	0	13247	126354	1606	0	1770	10425	28461	41708	0.6823870720245516	19421.418456890762
PANTHER_count_0.2_1e-30	21999	6832	1411	137820	974	629	171	10444	28831	30242	0.9533430328681965	27485.832980622974
PANTHER_count_0.2_1e-20	32918	10310	3043	121791	1486	1005	372	10380	43228	46271	0.9342352661494241	40385.1220851073
PANTHER_count_0.2_1e-15	39037	12481	4101	112443	1780	1262	498	10342	51518	55619	0.9262662039950377	47719.38229741635
PANTHER_count_0.2_1e-10	45171	14956	5210	102725	2093	1513	658	10294	60127	65337	0.9202595772686227	55332.44760243048
PANTHER_count_0.2_1e-05	49507	16312	6252	95991	2310	1691	829	10246	65819	72071	0.9132522096266182	60109.347185414386
PANTHER_count_0.2_0.01	50533	16540	6589	94400	2372	1735	894	10238	67073	73662	0.9105508946268089	61073.38015530396
PANTHER_count_0.2_1	50704	16575	6691	94092	2381	1742	935	10229	67279	73970	0.9095444098959038	61193.238353386514
InterPro_count_0.2_1e-30	15223	15044	2	137793	801	911	1	10444	30267	30269	0.9999339257986719	30265.0001321484
InterPro_count_0.2_1e-20	24055	22235	24	121748	1328	1395	4	10381	46290	46314	0.9994817981603835	46266.012436844154
InterPro_count_0.2_1e-15	28964	26668	64	112366	1604	1694	9	10343	55632	55696	0.9988509049123815	55568.07354208561
InterPro_count_0.2_1e-10	34517	30984	76	102485	1952	2014	13	10295	65501	65577	0.9988410570779389	65425.08807966208
InterPro_count_0.2_1e-05	38354	34162	94	95452	2236	2287	21	10243	72516	72610	0.9987054124776201	72422.1216912271
InterPro_count_0.2_0.01	39577	34967	135	93383	2332	2391	38	10231	74544	74679	0.9981922628851484	74409.2440445105
InterPro_count_0.2_1	39880	35179	238	92765	2363	2432	99	10212	75059	75297	0.9968391835000067	74821.752274327
Pfam_count_0.2_1e-30	22632	7012	205	138213	981	506	23	10447	29644	29849	0.9931320982277463	29440.40791986331
Pfam_count_0.2_1e-20	35344	9345	561	122812	1570	769	63	10389	44689	45250	0.9876022099447513	44134.95516022099
Pfam_count_0.2_1e-15	42555	10779	845	113883	1895	911	95	10355	53334	54179	0.984403551191421	52502.178999243246
Pfam_count_0.2_1e-10	50357	12118	977	104610	2292	1050	122	10311	62475	63452	0.9846025341990796	61513.0433240875
Pfam_count_0.2_1e-05	55871	12808	1167	98216	2611	1140	166	10266	68679	69846	0.9832918134180912	67531.4984537411
Pfam_count_0.2_0.01	57411	12939	1285	96427	2706	1163	207	10258	70350	71635	0.9820618412787046	69088.05053395686
Pfam_count_0.2_1	57747	12945	1373	95997	2737	1166	263	10242	70692	72065	0.9809477554985083	69345.15873170055
eggNOG_count_0.2_1e-30	9376	146	1398	157142	577	30	199	10498	9522	10920	0.871978021978022	8302.974725274726
eggNOG_count_0.2_1e-20	14139	187	2233	151503	903	49	340	10482	14326	16559	0.8651488616462347	12394.122591943958
eggNOG_count_0.2_1e-15	17077	241	2778	147966	1099	57	450	10475	17318	20096	0.8617635350318471	14924.020899681529
eggNOG_count_0.2_1e-10	19912	265	3417	144468	1278	65	568	10461	20177	23594	0.8551750445028397	17254.866872933795
eggNOG_count_0.2_1e-05	21508	285	4636	141633	1369	72	758	10458	21793	26429	0.8245866283249461	17970.216391085552
eggNOG_count_0.2_0.01	21670	285	5250	140857	1376	72	853	10456	21955	27205	0.8070207682411321	17718.140966734056
eggNOG_count_0.2_1	21673	285	5484	140620	1378	72	911	10450	21958	27442	0.800160338167772	17569.920705487937
EC number_count_0.25_1e-30	9583	190	1246	157043	333	30	111	10496	9773	11019	0.8869225882566476	8667.894455032218
EC number_count_0.25_1e-20	11795	238	1849	154180	427	35	162	10491	12033	13882	0.8668059357441291	10430.275824809105
EC number_count_0.25_1e-15	12693	258	2026	153085	456	37	177	10490	12951	14977	0.8647259130667023	11199.065300126862
EC number_count_0.25_1e-10	13344	266	2089	152363	483	38	181	10489	13610	15699	0.8669341996305497	11798.974456971782
EC number_count_0.25_1e-05	13556	290	2112	152104	494	39	184	10488	13846	15958	0.8676525880436144	12013.517734051886
EC number_count_0.25_0.01	13576	290	2117	152079	494	39	184	10488	13866	15983	0.867546768441469	12029.40349120941
EC number_count_0.25_1	13592	290	2117	152063	494	39	184	10488	13882	15999	0.867679229951872	12045.123070191887
Protein families_count_0.25_1e-30	16628	248	1376	149810	580	31	126	10488	16876	18252	0.9246110015340785	15603.73526188911
Protein families_count_0.25_1e-20	23505	296	1778	142483	801	43	176	10481	23801	25579	0.9304898549591462	22146.589037882637
Protein families_count_0.25_1e-15	27125	310	1968	138659	928	48	191	10475	27435	29403	0.9330680542801755	25598.722069176612
Protein families_count_0.25_1e-10	30803	342	2080	134837	1064	51	214	10467	31145	33225	0.9373965387509405	29195.215199398044
Protein families_count_0.25_1e-05	33279	344	2114	132325	1161	52	222	10461	33623	35737	0.9408456221842908	31634.05235470241
Protein families_count_0.25_0.01	33932	348	2152	131630	1189	53	232	10459	34280	36432	0.9409310496267018	32255.116381203337
Protein families_count_0.25_1	34040	348	2155	131519	1198	53	233	10457	34388	36543	0.941028377527844	32360.083846427497
OrthoDB_count_0.25_1e-30	10637	0	2770	154655	588	0	317	10497	10637	13407	0.7933915118967704	8439.305512045947
OrthoDB_count_0.25_1e-20	15623	0	3813	148626	873	0	476	10489	15623	19436	0.8038176579543116	12558.04327022021
OrthoDB_count_0.25_1e-15	18370	0	4534	145158	1022	0	585	10484	18370	22904	0.8020433112120153	14733.535626964722
OrthoDB_count_0.25_1e-10	21070	0	5601	141391	1171	0	740	10477	21070	26671	0.7899966255483484	16645.2289003037
OrthoDB_count_0.25_1e-05	22383	0	6648	139031	1245	0	890	10472	22383	29031	0.7710034101477731	17257.369329337605
OrthoDB_count_0.25_0.01	22648	0	7011	138403	1263	0	947	10470	22648	29659	0.763613068545804	17294.30877642537
OrthoDB_count_0.25_1	22671	0	7110	138281	1267	0	977	10468	22671	29781	0.7612571773949833	17258.461468721667
PANTHER_count_0.25_1e-30	19127	5825	934	142176	820	536	111	10467	24952	25886	0.9639187205439234	24051.699915011977
PANTHER_count_0.25_1e-20	27016	8161	1636	131249	1181	788	212	10442	35177	36813	0.9555591774644826	33613.70518566811
PANTHER_count_0.25_1e-15	31120	9495	2103	125344	1374	945	264	10425	40615	42718	0.9507701671426565	38615.530338499
PANTHER_count_0.25_1e-10	35221	11057	2570	119214	1578	1116	334	10401	46278	48848	0.9473878152636751	43843.21331477236
PANTHER_count_0.25_1e-05	37915	11887	3025	115235	1722	1223	408	10379	49802	52827	0.9427376152346338	46950.21871391524
PANTHER_count_0.25_0.01	38517	12008	3137	114400	1766	1247	436	10375	50525	53662	0.9415415005031493	47571.38431292162
PANTHER_count_0.25_1	38616	12029	3163	114254	1775	1251	446	10372	50645	53808	0.941216919417187	47667.93088388343
InterPro_count_0.25_1e-30	13861	12056	0	142145	696	726	0	10467	25917	25917	1.0	25917.0
InterPro_count_0.25_1e-20	20693	16154	16	131199	1044	1035	2	10443	36847	36863	0.9995659604481458	36831.00694463283
InterPro_count_0.25_1e-15	24204	18545	36	125277	1221	1202	4	10426	42749	42785	0.9991585836157532	42713.03029098983
InterPro_count_0.25_1e-10	27951	20982	38	119091	1435	1406	5	10402	48933	48971	0.9992240305486921	48895.02948683915
InterPro_count_0.25_1e-05	30323	22653	40	115046	1620	1546	6	10380	52976	53016	0.9992455107891958	52936.030179568435
InterPro_count_0.25_0.01	30998	23034	42	113988	1682	1596	7	10376	54032	54074	0.9992232866072419	53990.0326219625
InterPro_count_0.25_1	31141	23130	56	113735	1709	1611	17	10370	54271	54327	0.9989692049993557	54215.05772452003
Pfam_count_0.25_1e-30	20027	5483	191	142361	845	383	18	10468	25510	25701	0.992568382553208	25320.419438932335
Pfam_count_0.25_1e-20	29332	6717	407	131606	1244	543	40	10445	36049	36456	0.9888358569234146	35646.54380623217
Pfam_count_0.25_1e-15	34182	7459	527	125894	1451	623	50	10431	41641	42168	0.9875023714665149	41120.586250237146
Pfam_count_0.25_1e-10	39367	8156	588	119951	1698	706	65	10409	47523	48111	0.9877782627673505	46942.1863814928
Pfam_count_0.25_1e-05	42810	8479	651	116122	1900	757	79	10388	51289	51940	0.9874663072776281	50646.15943396227
Pfam_count_0.25_0.01	43653	8556	671	115182	1961	770	89	10385	52209	52880	0.9873108925869895	51546.51439107413
Pfam_count_0.25_1	43820	8557	682	115003	1985	771	98	10381	52377	53059	0.9871463842137997	51703.76616596619
eggNOG_count_0.25_1e-30	7791	103	1103	159065	453	20	161	10505	7894	8997	0.877403578970768	6926.223852395243
eggNOG_count_0.25_1e-20	11122	123	1548	155269	672	30	242	10499	11245	12793	0.8789963261158446	9884.313687172673
eggNOG_count_0.25_1e-15	13156	145	1803	152958	798	34	292	10495	13301	15104	0.8806276483050848	11713.228350105932
eggNOG_count_0.25_1e-10	15206	163	2060	150633	930	42	351	10486	15369	17429	0.8818061850938091	13552.479258706753
eggNOG_count_0.25_1e-05	16397	179	2527	148959	1001	47	440	10485	16576	19103	0.8677171124954196	14383.278856724075
eggNOG_count_0.25_0.01	16524	179	2811	148548	1010	47	474	10484	16703	19514	0.8559495746643435	14296.92574561853
eggNOG_count_0.25_1	16527	179	2874	148482	1012	47	488	10483	16706	19580	0.853217568947906	14253.852706843718
EC number_count_0.3_1e-30	8212	160	1034	158656	285	27	88	10499	8372	9406	0.8900701679778864	7451.667446310865
EC number_count_0.3_1e-20	9702	186	1401	156773	348	31	121	10497	9888	11289	0.8758968907786341	8660.868456019134
EC number_count_0.3_1e-15	10293	192	1511	156066	368	32	128	10496	10485	11996	0.8740413471157052	9164.323524508169
EC number_count_0.3_1e-10	10713	192	1528	155629	383	32	130	10496	10905	12433	0.8771012627684388	9564.789270489826
EC number_count_0.3_1e-05	10837	202	1544	155479	390	33	131	10496	11039	12583	0.8772947627751728	9684.456886275133
EC number_count_0.3_0.01	10848	202	1544	155468	390	33	131	10496	11050	12594	0.8774019374305224	9695.291408607272
EC number_count_0.3_1	10848	202	1544	155468	390	33	131	10496	11050	12594	0.8774019374305224	9695.291408607272
Protein families_count_0.3_1e-30	14184	216	1061	152601	489	26	94	10494	14400	15461	0.9313757195524223	13411.81036155488
Protein families_count_0.3_1e-20	19262	242	1306	147252	657	32	119	10489	19504	20810	0.9372417107160019	18279.962325804903
Protein families_count_0.3_1e-15	21886	254	1443	144479	749	37	127	10484	22140	23583	0.9388118559979647	20785.29449179494
Protein families_count_0.3_1e-10	24444	270	1490	141858	847	39	140	10479	24714	26204	0.9431384521447107	23308.72370630438
Protein families_count_0.3_1e-05	26136	272	1508	140146	904	40	145	10476	26408	27916	0.9459807995414816	24981.460954291448
Protein families_count_0.3_0.01	26499	274	1514	139775	922	41	147	10475	26773	28287	0.946477180330187	25340.033548980096
Protein families_count_0.3_1	26552	274	1514	139722	926	41	147	10473	26826	28340	0.9465772759350741	25392.8820042343
OrthoDB_count_0.3_1e-30	8517	0	2123	157422	467	0	247	10502	8517	10640	0.80046992481203	6817.60234962406
OrthoDB_count_0.3_1e-20	12074	0	2615	153373	661	0	330	10498	12074	14689	0.821975628020968	9924.533732725167
OrthoDB_count_0.3_1e-15	14016	0	2963	151083	768	0	383	10497	14016	16979	0.8254903115613405	11570.072206843748
OrthoDB_count_0.3_1e-10	15880	0	3514	148668	875	0	458	10493	15880	19394	0.8188099412189337	13002.701866556667
OrthoDB_count_0.3_1e-05	16796	0	3978	147288	931	0	518	10491	16796	20774	0.8085106382978723	13579.744680851063
OrthoDB_count_0.3_0.01	16994	0	4086	146982	944	0	540	10490	16994	21080	0.8061669829222011	13700.001707779886
OrthoDB_count_0.3_1	17009	0	4105	146948	946	0	544	10489	17009	21114	0.8055792365255281	13702.097234062707
PANTHER_count_0.3_1e-30	15556	4671	548	147287	677	430	61	10482	20227	20775	0.9736221419975932	19693.455066185317
PANTHER_count_0.3_1e-20	21104	6077	906	139975	923	590	107	10468	27181	28087	0.9677430839890341	26304.224765905936
PANTHER_count_0.3_1e-15	23941	6856	1157	136108	1055	687	128	10458	30797	31954	0.9637917005695688	29681.893002441007
PANTHER_count_0.3_1e-10	26579	7864	1437	132182	1194	792	163	10448	34443	35880	0.9599498327759197	33063.552090301004
PANTHER_count_0.3_1e-05	28233	8352	1665	129812	1273	854	196	10438	36585	38250	0.9564705882352941	34992.47647058823
PANTHER_count_0.3_0.01	28576	8413	1710	129363	1302	865	205	10437	36989	38699	0.9558128117005608	35354.56009199204
PANTHER_count_0.3_1	28618	8424	1714	129306	1305	867	205	10435	37042	38756	0.9557745897409433	35403.80235318402
InterPro_count_0.3_1e-30	11793	9044	0	147225	581	566	0	10482	20837	20837	1.0	20837.0
InterPro_count_0.3_1e-20	16837	11331	12	139882	821	748	1	10468	28168	28180	0.9995741660752306	28156.005110007096
InterPro_count_0.3_1e-15	19312	12746	16	135988	926	850	2	10458	32058	32074	0.9995011535823408	32042.007981542683
InterPro_count_0.3_1e-10	21794	14208	18	132042	1070	952	3	10448	36002	36020	0.9995002776235424	35984.008995002776
InterPro_count_0.3_1e-05	23308	15098	18	129638	1163	1039	3	10438	38406	38424	0.999531542785759	38388.00843222986
InterPro_count_0.3_0.01	23696	15235	18	129113	1199	1060	3	10437	38931	38949	0.9995378571978741	38913.008318570435
InterPro_count_0.3_1	23755	15269	20	129018	1208	1065	5	10433	39024	39044	0.9994877574019055	39004.01024485196
Pfam_count_0.3_1e-30	16480	4110	152	147320	683	290	15	10483	20590	20742	0.992671873493395	20439.113875229003
Pfam_count_0.3_1e-20	23000	4727	283	140052	957	376	29	10470	27727	28010	0.9898964655480186	27446.85930024991
Pfam_count_0.3_1e-15	26272	5179	360	136251	1086	422	35	10462	31451	31811	0.9886831599132375	31095.074062431235
Pfam_count_0.3_1e-10	29739	5520	390	132413	1245	460	41	10453	35259	35649	0.9890600016830766	34873.266599343595
Pfam_count_0.3_1e-05	31932	5663	410	130057	1352	492	48	10444	37595	38005	0.9892119457966058	37189.423102223394
Pfam_count_0.3_0.01	32401	5686	411	129564	1387	499	49	10443	38087	38498	0.9893241207335446	37680.38778637851
Pfam_count_0.3_1	32481	5686	412	129483	1394	499	50	10440	38167	38579	0.9893206148422717	37759.39990668499
eggNOG_count_0.3_1e-30	5961	86	768	161247	344	14	116	10508	6047	6815	0.8873074101247249	5365.547909024212
eggNOG_count_0.3_1e-20	8231	101	962	158768	483	21	159	10506	8332	9294	0.8964923606627933	7469.574349042394
eggNOG_count_0.3_1e-15	9728	111	1113	157110	565	22	185	10505	9839	10952	0.8983747260774287	8839.108929875822
eggNOG_count_0.3_1e-10	11105	117	1237	155603	650	26	211	10500	11222	12459	0.9007143430451883	10107.816357653102
eggNOG_count_0.3_1e-05	11939	128	1428	154567	698	30	258	10500	12067	13495	0.8941830307521305	10790.106632085959
eggNOG_count_0.3_0.01	12039	128	1555	154340	705	30	277	10499	12167	13722	0.8866783267745226	10788.215201865616
eggNOG_count_0.3_1	12041	128	1567	154326	706	30	280	10498	12169	13736	0.8859202096680256	10780.763031450204
EC number_count_0.35_1e-30	6740	108	671	160543	240	18	61	10501	6848	7519	0.9107594094959436	6236.880436228222
EC number_count_0.35_1e-20	7614	122	918	159408	280	21	84	10500	7736	8654	0.8939218858331407	6915.379708805176
EC number_count_0.35_1e-15	7933	122	999	159008	293	21	89	10500	8055	9054	0.889662027833002	7166.227634194831
EC number_count_0.35_1e-10	8158	122	1013	158769	303	21	90	10500	8280	9293	0.8909932207037555	7377.4238674270955
EC number_count_0.35_1e-05	8184	122	1015	158741	305	21	90	10500	8306	9321	0.8911061044952259	7401.527303937346
EC number_count_0.35_0.01	8188	122	1015	158737	306	21	90	10500	8310	9325	0.8911528150134048	7405.479892761394
EC number_count_0.35_1	8188	122	1015	158737	306	21	90	10500	8310	9325	0.8911528150134048	7405.479892761394
Protein families_count_0.35_1e-30	11202	131	841	155888	407	19	74	10499	11333	12174	0.9309183505832102	10550.09766715952
Protein families_count_0.35_1e-20	14748	147	1004	152163	532	23	87	10496	14895	15899	0.9368513743002704	13954.401220202528
Protein families_count_0.35_1e-15	16723	153	1075	150111	592	26	92	10494	16876	17951	0.9401147568380591	15865.376636399085
Protein families_count_0.35_1e-10	18373	155	1090	148444	658	27	97	10492	18528	19618	0.9444387807115914	17498.561729024364
Protein families_count_0.35_1e-05	19443	155	1094	147370	698	27	99	10491	19598	20692	0.9471293253431278	18561.84051807462
Protein families_count_0.35_0.01	19685	157	1100	147120	711	28	101	10491	19842	20942	0.947473975742527	18799.778626683223
Protein families_count_0.35_1	19708	157	1100	147097	712	28	101	10490	19865	20965	0.9475316002861913	18822.71523968519
OrthoDB_count_0.35_1e-30	6454	0	1476	160132	350	0	182	10503	6454	7930	0.8138713745271122	5252.725851197983
OrthoDB_count_0.35_1e-20	8868	0	1701	157493	481	0	220	10501	8868	10569	0.8390576213454443	7440.762986091399
OrthoDB_count_0.35_1e-15	10261	0	1903	155898	554	0	253	10500	10261	12164	0.8435547517264058	8655.71530746465
OrthoDB_count_0.35_1e-10	11384	0	2208	154470	620	0	290	10500	11384	13592	0.8375515008828722	9534.686286050617
OrthoDB_count_0.35_1e-05	11932	0	2432	153698	654	0	324	10499	11932	14364	0.8306878306878307	9911.767195767196
OrthoDB_count_0.35_0.01	12067	0	2474	153521	666	0	331	10499	12067	14541	0.8298603947458909	10013.925383398666
OrthoDB_count_0.35_1	12074	0	2479	153509	668	0	332	10498	12074	14553	0.8296571153714011	10017.280010994296
PANTHER_count_0.35_1e-30	11997	3321	295	152449	531	317	35	10492	15318	15613	0.9811054890155639	15028.573880740409
PANTHER_count_0.35_1e-20	15745	4168	474	147675	703	416	58	10484	19913	20387	0.9767498896355521	19450.020552312748
PANTHER_count_0.35_1e-15	17766	4626	635	145035	792	473	70	10480	22392	23027	0.972423676553611	21774.510965388457
PANTHER_count_0.35_1e-10	19435	5169	787	142671	878	543	85	10477	24604	25391	0.9690047654680792	23841.39324957662
PANTHER_count_0.35_1e-05	20406	5488	857	141311	926	581	99	10474	25894	26751	0.9679638144368434	25064.455011027625
PANTHER_count_0.35_0.01	20621	5534	875	141032	946	590	103	10474	26155	27030	0.9676285608583056	25308.325009248983
PANTHER_count_0.35_1	20645	5540	875	141002	947	591	103	10473	26185	27060	0.9676644493717664	25338.293606799703
InterPro_count_0.35_1e-30	9354	6321	0	152387	462	417	0	10492	15675	15675	1.0	15675.0
InterPro_count_0.35_1e-20	12835	7637	4	147586	629	522	1	10484	20472	20476	0.9998046493455753	20468.000781402618
InterPro_count_0.35_1e-15	14541	8612	4	144905	704	589	1	10480	23153	23157	0.9998272660534612	23149.000690935787
InterPro_count_0.35_1e-10	16063	9456	4	142539	791	650	1	10477	25519	25523	0.9998432786114485	25515.000626885554
InterPro_count_0.35_1e-05	16982	9915	4	141161	843	699	1	10474	26897	26901	0.9998513066428757	26893.000594773428
InterPro_count_0.35_0.01	17240	9975	4	140843	863	706	1	10474	27215	27219	0.9998530438296778	27211.00058782468
InterPro_count_0.35_1	17273	9990	4	140795	866	708	1	10472	27263	27267	0.999853302526864	27259.000586789894
Pfam_count_0.35_1e-30	12671	2865	71	152455	541	201	10	10493	15536	15607	0.9954507592746844	15465.322996091498
Pfam_count_0.35_1e-20	17104	3113	144	147701	720	244	18	10485	20217	20361	0.9929276558125829	20074.018417562987
Pfam_count_0.35_1e-15	19438	3368	184	145072	805	273	22	10481	22806	22990	0.9919965202261853	22623.47264027838
Pfam_count_0.35_1e-10	21555	3543	194	142770	907	291	25	10478	25098	25292	0.9923295903843112	24905.488059465442
Pfam_count_0.35_1e-05	22868	3583	200	141411	972	303	28	10475	26451	26651	0.9924955911598063	26252.50088176804
Pfam_count_0.35_0.01	23157	3594	200	141111	991	308	28	10475	26751	26951	0.9925791250788468	26552.48417498423
Pfam_count_0.35_1	23203	3594	200	141065	993	308	28	10474	26797	26997	0.9925917694558655	26598.481646108827
eggNOG_count_0.35_1e-30	4285	72	469	163236	249	9	77	10508	4357	4826	0.9028180687940324	3933.578325735599
eggNOG_count_0.35_1e-20	5797	78	567	161620	337	12	103	10507	5875	6442	0.9119838559453586	5357.905153678982
eggNOG_count_0.35_1e-15	6910	82	650	160420	396	12	118	10506	6992	7642	0.9149437320073279	6397.286574195236
eggNOG_count_0.35_1e-10	7764	86	709	159503	444	14	134	10505	7850	8559	0.9171632200023367	7199.7312770183435
eggNOG_count_0.35_1e-05	8325	87	761	158889	482	15	153	10505	8412	9173	0.9170391365965334	7714.133217050038
eggNOG_count_0.35_0.01	8393	87	834	158748	487	15	160	10505	8480	9314	0.9104573759931286	7720.678548421731
eggNOG_count_0.35_1	8395	87	838	158742	488	15	162	10504	8482	9320	0.9100858369098712	7719.3480686695275
EC number_count_0.4_1e-30	5191	86	418	162367	185	17	40	10504	5277	5695	0.9266022827041265	4889.680245829675
EC number_count_0.4_1e-20	5644	86	563	161769	208	17	54	10503	5730	6293	0.910535515652312	5217.368504687748
EC number_count_0.4_1e-15	5735	86	598	161643	213	17	57	10503	5821	6419	0.9068390715064651	5278.710235239134
EC number_count_0.4_1e-10	5858	86	606	161512	219	17	58	10503	5944	6550	0.9074809160305344	5394.0665648854965
EC number_count_0.4_1e-05	5867	86	606	161503	221	17	58	10503	5953	6559	0.9076078670529044	5402.98963256594
EC number_count_0.4_0.01	5869	86	606	161501	222	17	58	10503	5955	6561	0.9076360310928212	5404.97256515775
EC number_count_0.4_1	5869	86	606	161501	222	17	58	10503	5955	6561	0.9076360310928212	5404.97256515775
Protein families_count_0.4_1e-30	8361	68	591	159042	306	14	58	10503	8429	9020	0.9344789356984479	7876.722949002217
Protein families_count_0.4_1e-20	10784	78	706	156494	395	17	67	10501	10862	11568	0.938969571230982	10199.087482710927
Protein families_count_0.4_1e-15	12099	82	743	155138	440	19	69	10501	12181	12924	0.9425100588053235	11480.715026307646
Protein families_count_0.4_1e-10	13135	82	743	154102	482	19	69	10501	13217	13960	0.9467765042979943	12513.54505730659
Protein families_count_0.4_1e-05	13825	82	745	153410	511	19	70	10500	13907	14652	0.9491536991536992	13199.880494130495
Protein families_count_0.4_0.01	13964	82	747	153269	517	19	71	10500	14046	14793	0.9495031433786251	13336.721151896169
Protein families_count_0.4_1	13981	82	747	153252	519	19	71	10499	14063	14810	0.949561107359892	13353.67785280216
OrthoDB_count_0.4_1e-30	4647	0	925	162490	259	0	129	10504	4647	5572	0.8339913854989232	3875.557968413496
OrthoDB_count_0.4_1e-20	6202	0	1035	160825	345	0	158	10503	6202	7237	0.8569849385104324	5315.0205886417025
OrthoDB_count_0.4_1e-15	7179	0	1160	159723	392	0	178	10503	7179	8339	0.8608945916776591	6180.362273653915
OrthoDB_count_0.4_1e-10	7847	0	1318	158897	428	0	194	10503	7847	9165	0.8561920349154392	6718.538897981451
OrthoDB_count_0.4_1e-05	8203	0	1401	158458	448	0	208	10503	8203	9604	0.8541232819658475	7006.373281965847
OrthoDB_count_0.4_0.01	8266	0	1428	158368	455	0	211	10503	8266	9694	0.8526923870435321	7048.355271301836
OrthoDB_count_0.4_1	8272	0	1433	158357	457	0	212	10502	8272	9705	0.852344152498712	7050.590829469345
PANTHER_count_0.4_1e-30	8965	2132	111	156854	399	227	18	10498	11097	11208	0.9900963597430407	10987.099304068523
PANTHER_count_0.4_1e-20	11418	2699	209	153736	516	285	31	10493	14117	14326	0.9854111405835544	13911.049071618037
PANTHER_count_0.4_1e-15	12709	3029	282	152042	578	327	37	10493	15738	16020	0.9823970037453184	15460.964044943821
PANTHER_count_0.4_1e-10	13730	3337	352	150643	630	365	44	10493	17067	17419	0.9797921809518342	16722.113152304955
PANTHER_count_0.4_1e-05	14323	3524	375	149840	661	391	48	10491	17847	18222	0.9794204807375699	17479.71731972341
PANTHER_count_0.4_0.01	14460	3554	377	149671	668	399	49	10491	18014	18391	0.9795008428035452	17644.728182263065
PANTHER_count_0.4_1	14479	3560	377	149646	669	400	49	10490	18039	18416	0.979528670721112	17669.71769113814
InterPro_count_0.4_1e-30	7221	4051	0	156790	350	289	0	10498	11272	11272	1.0	11272.0
InterPro_count_0.4_1e-20	9539	4857	0	153666	458	356	0	10493	14396	14396	1.0	14396.0
InterPro_count_0.4_1e-15	10590	5540	0	151932	509	398	0	10493	16130	16130	1.0	16130.0
InterPro_count_0.4_1e-10	11504	6025	0	150533	558	431	0	10493	17529	17529	1.0	17529.0
InterPro_count_0.4_1e-05	12057	6283	0	149722	593	461	0	10491	18340	18340	1.0	18340.0
InterPro_count_0.4_0.01	12204	6309	0	149549	603	463	0	10491	18513	18513	1.0	18513.0
InterPro_count_0.4_1	12229	6322	0	149511	605	465	0	10490	18551	18551	1.0	18551.0
Pfam_count_0.4_1e-30	9448	1736	50	156828	400	140	7	10499	11184	11234	0.9955492255652484	11134.222538721739
Pfam_count_0.4_1e-20	12399	1830	86	153747	521	158	9	10494	14229	14315	0.993992315752707	14143.516660845267
Pfam_count_0.4_1e-15	13984	1950	94	152034	577	173	11	10494	15934	16028	0.9941352632892438	15840.55128525081
Pfam_count_0.4_1e-10	15219	2056	96	150691	635	181	12	10494	17275	17371	0.9944735478671349	17179.530539404757
Pfam_count_0.4_1e-05	16003	2065	97	149897	676	183	13	10492	18068	18165	0.9946600605560143	17971.517974126065
Pfam_count_0.4_0.01	16164	2065	97	149736	685	183	13	10492	18229	18326	0.9947069736985703	18132.513423551238
Pfam_count_0.4_1	16201	2065	97	149699	687	183	13	10491	18266	18363	0.994717638730055	18169.512389043186
eggNOG_count_0.4_1e-30	2993	22	223	164824	179	5	41	10508	3015	3238	0.9311303273625695	2807.357936998147
eggNOG_count_0.4_1e-20	3957	22	267	163816	236	5	52	10508	3979	4246	0.9371172868582195	3728.7896844088555
eggNOG_count_0.4_1e-15	4749	22	305	162986	275	5	63	10508	4771	5076	0.9399133175728921	4484.326438140268
eggNOG_count_0.4_1e-10	5240	22	317	162483	303	5	69	10508	5262	5579	0.9431797813228177	4963.012009320667
eggNOG_count_0.4_1e-05	5587	22	338	162115	326	5	76	10508	5609	5947	0.9431646208172187	5290.21035816378
eggNOG_count_0.4_0.01	5617	22	380	162043	328	5	80	10508	5639	6019	0.9368665891344077	5282.990696128925
eggNOG_count_0.4_1	5619	22	382	162039	329	5	81	10507	5641	6023	0.9365764569151586	5283.227793458409
EC number_count_0.45_1e-30	3519	66	273	164204	149	11	28	10505	3585	3858	0.9292379471228616	3331.318040435459
EC number_count_0.45_1e-20	3748	66	354	163894	161	11	37	10504	3814	4168	0.9150671785028791	3490.066218809981
EC number_count_0.45_1e-15	3776	66	358	163862	163	11	38	10504	3842	4200	0.9147619047619048	3514.515238095238
EC number_count_0.45_1e-10	3851	66	360	163785	167	11	39	10504	3917	4277	0.9158288519990647	3587.3016132803364
EC number_count_0.45_1e-05	3856	66	360	163780	170	11	39	10504	3922	4282	0.9159271368519384	3592.2662307333026
EC number_count_0.45_0.01	3857	66	360	163779	170	11	39	10504	3923	4283	0.915946766285314	3593.259164137287
EC number_count_0.45_1	3857	66	360	163779	170	11	39	10504	3923	4283	0.915946766285314	3593.259164137287
Protein families_count_0.45_1e-30	5956	38	339	161729	236	6	38	10504	5994	6333	0.946470866887731	5673.14637612506
Protein families_count_0.45_1e-20	7525	46	414	160077	296	8	46	10502	7571	7985	0.94815278647464	7178.464746399499
Protein families_count_0.45_1e-15	8375	48	430	159209	328	9	48	10502	8423	8853	0.9514288941601717	8013.885575511126
Protein families_count_0.45_1e-10	8999	48	430	158585	354	9	48	10502	9047	9477	0.9546269916640286	8636.510393584467
Protein families_count_0.45_1e-05	9477	48	430	158107	376	9	48	10501	9525	9955	0.9568056253139126	9113.573581115017
Protein families_count_0.45_0.01	9532	48	432	158050	379	9	49	10501	9580	10012	0.9568517778665602	9166.640031961646
Protein families_count_0.45_1	9547	48	432	158035	380	9	49	10501	9595	10027	0.956916325920016	9181.612147202553
OrthoDB_count_0.45_1e-30	3115	0	623	164324	176	0	82	10505	3115	3738	0.8333333333333334	2595.8333333333335
OrthoDB_count_0.45_1e-20	4122	0	687	163253	233	0	100	10504	4122	4809	0.8571428571428571	3533.142857142857
OrthoDB_count_0.45_1e-15	4750	0	765	162547	266	0	110	10504	4750	5515	0.8612873980054397	4091.115140525839
OrthoDB_count_0.45_1e-10	5083	0	851	162128	283	0	118	10504	5083	5934	0.8565891472868217	4354.042635658914
OrthoDB_count_0.45_1e-05	5335	0	875	161852	300	0	122	10504	5335	6210	0.8590982286634461	4583.289049919485
OrthoDB_count_0.45_0.01	5357	0	892	161813	303	0	123	10504	5357	6249	0.8572571611457833	4592.326612257962
OrthoDB_count_0.45_1	5361	0	897	161804	304	0	124	10504	5361	6258	0.8566634707574304	4592.572866730585
PANTHER_count_0.45_1e-30	6188	1399	71	160404	296	161	9	10500	7587	7658	0.9907286497780099	7516.658265865761
PANTHER_count_0.45_1e-20	7769	1744	105	158444	374	198	15	10496	9513	9618	0.9890829694323144	9409.146288209608
PANTHER_count_0.45_1e-15	8596	1964	147	157355	414	224	16	10496	10560	10707	0.9862706640515551	10415.01821238442
PANTHER_count_0.45_1e-10	9153	2145	172	156592	448	245	19	10496	11298	11470	0.9850043591979076	11128.579250217961
PANTHER_count_0.45_1e-05	9575	2236	180	156071	473	258	20	10494	11811	11991	0.9849887415561671	11633.70202651989
PANTHER_count_0.45_0.01	9630	2250	180	156002	477	261	20	10494	11880	12060	0.9850746268656716	11702.686567164179
PANTHER_count_0.45_1	9649	2254	180	155979	478	261	20	10494	11903	12083	0.9851030373251676	11725.68145328147
InterPro_count_0.45_1e-30	5293	2426	0	160343	252	199	0	10500	7719	7719	1.0	7719.0
InterPro_count_0.45_1e-20	6880	2803	0	158379	326	234	0	10496	9683	9683	1.0	9683.0
InterPro_count_0.45_1e-15	7508	3282	0	157272	358	263	0	10496	10790	10790	1.0	10790.0
InterPro_count_0.45_1e-10	8005	3548	0	156509	381	284	0	10496	11553	11553	1.0	11553.0
InterPro_count_0.45_1e-05	8376	3704	0	155982	408	301	0	10494	12080	12080	1.0	12080.0
InterPro_count_0.45_0.01	8442	3709	0	155911	412	302	0	10494	12151	12151	1.0	12151.0
InterPro_count_0.45_1	8465	3721	0	155876	413	303	0	10494	12186	12186	1.0	12186.0
Pfam_count_0.45_1e-30	6668	987	36	160371	291	81	5	10501	7655	7691	0.995319204264725	7619.1685086464695
Pfam_count_0.45_1e-20	8538	1020	68	158436	372	92	6	10497	9558	9626	0.9929357988780386	9490.480365676292
Pfam_count_0.45_1e-15	9583	1076	70	157333	410	102	7	10497	10659	10729	0.9934756268058533	10589.45670612359
Pfam_count_0.45_1e-10	10234	1134	70	156624	442	107	7	10497	11368	11438	0.9938800489596084	11298.428396572828
Pfam_count_0.45_1e-05	10750	1139	71	156102	469	108	8	10495	11889	11960	0.9940635451505017	11818.421488294314
Pfam_count_0.45_0.01	10817	1139	71	156035	472	108	8	10495	11956	12027	0.9940966159474516	11885.419140267732
Pfam_count_0.45_1	10852	1139	71	156000	473	108	8	10495	11991	12062	0.994113745647488	11920.41792405903
eggNOG_count_0.45_1e-30	1927	16	116	166003	117	3	24	10508	1943	2059	0.9436619718309859	1833.5352112676055
eggNOG_count_0.45_1e-20	2562	16	130	165354	154	3	29	10508	2578	2708	0.9519940915805022	2454.240768094535
eggNOG_count_0.45_1e-15	3088	16	142	164816	179	3	33	10508	3104	3246	0.9562538508934073	2968.2119531731364
eggNOG_count_0.45_1e-10	3388	16	146	164512	195	3	35	10508	3404	3550	0.9588732394366197	3264.0045070422534
eggNOG_count_0.45_1e-05	3627	16	154	164265	212	3	38	10508	3643	3797	0.9594416644719516	3495.2459836713197
eggNOG_count_0.45_0.01	3647	16	166	164233	214	3	39	10508	3663	3829	0.9566466440323844	3504.1966570906243
eggNOG_count_0.45_1	3647	16	166	164233	214	3	39	10508	3663	3829	0.9566466440323844	3504.1966570906243
EC number_count_0.5_1e-30	2087	40	136	165799	101	8	15	10506	2127	2263	0.9399027839151569	1999.1732213875387
EC number_count_0.5_1e-20	2205	40	190	165627	107	8	21	10505	2245	2435	0.9219712525667351	2069.8254620123203
EC number_count_0.5_1e-15	2211	40	190	165621	107	8	21	10505	2251	2441	0.9221630479311758	2075.7890208930767
EC number_count_0.5_1e-10	2237	40	190	165595	109	8	21	10505	2277	2467	0.92298338062424	2101.6331576813946
EC number_count_0.5_1e-05	2237	40	190	165595	109	8	21	10505	2277	2467	0.92298338062424	2101.6331576813946
EC number_count_0.5_0.01	2237	40	190	165595	109	8	21	10505	2277	2467	0.92298338062424	2101.6331576813946
EC number_count_0.5_1	2237	40	190	165595	109	8	21	10505	2277	2467	0.92298338062424	2101.6331576813946
Protein families_count_0.5_1e-30	3880	32	190	163960	161	4	21	10506	3912	4102	0.9536811311555339	3730.8005850804484
Protein families_count_0.5_1e-20	4882	38	232	162910	206	6	25	10504	4920	5152	0.9549689440993789	4698.447204968945
Protein families_count_0.5_1e-15	5462	38	236	162326	227	6	26	10504	5500	5736	0.9588563458856346	5273.709902370991
Protein families_count_0.5_1e-10	5805	38	236	161983	244	6	26	10504	5843	6079	0.9611778253002139	5616.1620332291495
Protein families_count_0.5_1e-05	6145	38	236	161643	259	6	26	10503	6183	6419	0.9632341486212805	5955.676740925378
Protein families_count_0.5_0.01	6175	38	236	161613	262	6	26	10503	6213	6449	0.9634051790975345	5985.6363777329825
Protein families_count_0.5_1	6183	38	236	161605	263	6	26	10503	6221	6457	0.963450518816788	5993.625677559238
OrthoDB_count_0.5_1e-30	1963	0	397	165702	116	0	55	10505	1963	2360	0.8317796610169491	1632.7834745762711
OrthoDB_count_0.5_1e-20	2596	0	432	165034	154	0	65	10504	2596	3028	0.857331571994716	2225.632760898283
OrthoDB_count_0.5_1e-15	3007	0	492	164563	175	0	70	10504	3007	3499	0.8593883966847671	2584.1809088310947
OrthoDB_count_0.5_1e-10	3150	0	558	164354	183	0	76	10504	3150	3708	0.8495145631067961	2675.9708737864075
OrthoDB_count_0.5_1e-05	3323	0	578	164161	191	0	79	10504	3323	3901	0.851832863368367	2830.6406049730836
OrthoDB_count_0.5_0.01	3331	0	590	164141	193	0	79	10504	3331	3921	0.84952818158633	2829.778372864065
OrthoDB_count_0.5_1	3335	0	594	164133	194	0	80	10504	3335	3929	0.8488164927462458	2830.80300330873
PANTHER_count_0.5_1e-30	3859	891	8	163304	197	102	2	10503	4750	4758	0.9983186212694409	4742.013451029845
PANTHER_count_0.5_1e-20	4788	1143	40	162091	250	131	7	10499	5931	5971	0.9933009546139675	5891.267961815442
PANTHER_count_0.5_1e-15	5330	1299	62	161371	272	151	7	10499	6629	6691	0.9907338215513376	6567.574503063817
PANTHER_count_0.5_1e-10	5614	1373	78	160997	290	162	8	10499	6987	7065	0.9889596602972399	6909.861146496815
PANTHER_count_0.5_1e-05	5910	1424	78	160650	306	171	8	10498	7334	7412	0.9894765245547761	7256.820831084728
PANTHER_count_0.5_0.01	5942	1432	78	160610	310	174	8	10498	7374	7452	0.9895330112721417	7296.816425120773
PANTHER_count_0.5_1	5954	1434	78	160596	311	174	8	10498	7388	7466	0.989552638628449	7310.814894186981
InterPro_count_0.5_1e-30	3615	1195	0	163252	182	113	0	10503	4810	4810	1.0	4810.0
InterPro_count_0.5_1e-20	4591	1436	0	162035	233	137	0	10499	6027	6027	1.0	6027.0
InterPro_count_0.5_1e-15	4976	1771	0	161315	249	156	0	10499	6747	6747	1.0	6747.0
InterPro_count_0.5_1e-10	5248	1873	0	160941	263	163	0	10499	7121	7121	1.0	7121.0
InterPro_count_0.5_1e-05	5517	1951	0	160594	276	174	0	10498	7468	7468	1.0	7468.0
InterPro_count_0.5_0.01	5557	1953	0	160552	280	174	0	10498	7510	7510	1.0	7510.0
InterPro_count_0.5_1	5571	1962	0	160529	281	175	0	10498	7533	7533	1.0	7533.0
Pfam_count_0.5_1e-30	4252	518	14	163278	199	48	3	10504	4770	4784	0.9970735785953178	4756.0409698996655
Pfam_count_0.5_1e-20	5421	543	34	162064	256	56	4	10500	5964	5998	0.9943314438146049	5930.192730910304
Pfam_count_0.5_1e-15	6113	569	34	161346	278	61	4	10500	6682	6716	0.9949374627754616	6648.172126265635
Pfam_count_0.5_1e-10	6431	572	34	161025	295	62	4	10500	7003	7037	0.9951683956231349	6969.164274548813
Pfam_count_0.5_1e-05	6773	574	35	160680	309	63	5	10499	7347	7382	0.9952587374695204	7312.165944188567
Pfam_count_0.5_0.01	6813	574	35	160640	312	63	5	10499	7387	7422	0.9952842899488009	7352.165049851792
Pfam_count_0.5_1	6836	574	35	160617	313	63	5	10499	7410	7445	0.9952988582941572	7375.164539959705
eggNOG_count_0.5_1e-30	1201	4	46	166811	72	2	12	10508	1205	1251	0.9632294164668266	1160.691446842526
eggNOG_count_0.5_1e-20	1589	4	54	166415	101	2	14	10508	1593	1647	0.9672131147540983	1540.7704918032787
eggNOG_count_0.5_1e-15	1950	4	60	166048	115	2	16	10508	1954	2014	0.9702085402184707	1895.7874875868918
eggNOG_count_0.5_1e-10	2105	4	61	165892	125	2	17	10508	2109	2170	0.971889400921659	2049.714746543779
eggNOG_count_0.5_1e-05	2265	4	67	165726	135	2	19	10508	2269	2336	0.971318493150685	2203.9216609589043
eggNOG_count_0.5_0.01	2279	4	69	165710	137	2	19	10508	2283	2352	0.9706632653061225	2216.0242346938776
eggNOG_count_0.5_1	2279	4	69	165710	137	2	19	10508	2283	2352	0.9706632653061225	2216.0242346938776
EC number_count_0.55_1e-30	1173	20	86	166783	53	4	11	10507	1193	1279	0.9327599687255669	1112.7826426896013
EC number_count_0.55_1e-20	1253	20	116	166673	55	4	16	10506	1273	1389	0.9164866810655148	1166.6875449964002
EC number_count_0.55_1e-15	1253	20	116	166673	55	4	16	10506	1273	1389	0.9164866810655148	1166.6875449964002
EC number_count_0.55_1e-10	1255	20	116	166671	56	4	16	10506	1275	1391	0.9166067577282531	1168.6736161035226
EC number_count_0.55_1e-05	1255	20	116	166671	56	4	16	10506	1275	1391	0.9166067577282531	1168.6736161035226
EC number_count_0.55_0.01	1255	20	116	166671	56	4	16	10506	1275	1391	0.9166067577282531	1168.6736161035226
EC number_count_0.55_1	1255	20	116	166671	56	4	16	10506	1275	1391	0.9166067577282531	1168.6736161035226
Protein families_count_0.55_1e-30	2408	22	159	165473	96	3	17	10506	2430	2589	0.9385863267670915	2280.7647740440325
Protein families_count_0.55_1e-20	3160	26	197	164679	122	4	21	10504	3186	3383	0.9417676618386048	3000.471770617795
Protein families_count_0.55_1e-15	3488	26	197	164351	134	4	21	10504	3514	3711	0.9469145782807868	3327.457828078685
Protein families_count_0.55_1e-10	3684	26	197	164155	143	4	21	10504	3710	3907	0.9495776810852317	3522.9331968262095
Protein families_count_0.55_1e-05	3860	26	197	163979	151	4	21	10504	3886	4083	0.9517511633602743	3698.505020818026
Protein families_count_0.55_0.01	3866	26	197	163973	152	4	21	10504	3892	4089	0.9518219613597456	3704.49107361213
Protein families_count_0.55_1	3868	26	197	163971	152	4	21	10504	3894	4091	0.9518455145441213	3706.4864336348082
OrthoDB_count_0.55_1e-30	1157	0	297	166608	66	0	36	10505	1157	1454	0.7957359009628611	920.6664374140303
OrthoDB_count_0.55_1e-20	1583	0	327	166152	87	0	44	10505	1583	1910	0.8287958115183246	1311.9837696335078
OrthoDB_count_0.55_1e-15	1772	0	384	165906	95	0	48	10505	1772	2156	0.8218923933209648	1456.3933209647496
OrthoDB_count_0.55_1e-10	1842	0	428	165792	99	0	52	10505	1842	2270	0.811453744493392	1494.697797356828
OrthoDB_count_0.55_1e-05	1933	0	436	165693	105	0	54	10505	1933	2369	0.8159560996200929	1577.2431405656396
OrthoDB_count_0.55_0.01	1933	0	438	165691	105	0	54	10505	1933	2371	0.8152678194854491	1575.912695065373
OrthoDB_count_0.55_1	1933	0	438	165691	105	0	54	10505	1933	2371	0.8152678194854491	1575.912695065373
PANTHER_count_0.55_1e-30	2342	608	2	165110	117	67	1	10504	2950	2952	0.9993224932249323	2948.00135501355
PANTHER_count_0.55_1e-20	2978	794	32	164258	147	86	5	10501	3772	3804	0.9915878023133544	3740.269190325973
PANTHER_count_0.55_1e-15	3244	893	34	163891	157	101	5	10501	4137	4171	0.9918484775833134	4103.277151762168
PANTHER_count_0.55_1e-10	3390	932	50	163690	166	106	6	10501	4322	4372	0.9885635864592863	4272.571820677035
PANTHER_count_0.55_1e-05	3539	961	50	163512	175	111	6	10501	4500	4550	0.989010989010989	4450.549450549451
PANTHER_count_0.55_0.01	3551	961	50	163500	177	111	6	10501	4512	4562	0.9890398947829899	4462.548005260851
PANTHER_count_0.55_1	3558	961	50	163493	177	111	6	10501	4519	4569	0.9890566863646312	4469.547165681768
InterPro_count_0.55_1e-30	2406	586	0	165070	115	60	0	10504	2992	2992	1.0	2992.0
InterPro_count_0.55_1e-20	3100	746	0	164216	143	76	0	10501	3846	3846	1.0	3846.0
InterPro_count_0.55_1e-15	3337	876	0	163849	153	83	0	10501	4213	4213	1.0	4213.0
InterPro_count_0.55_1e-10	3483	931	0	163648	161	86	0	10501	4414	4414	1.0	4414.0
InterPro_count_0.55_1e-05	3642	950	0	163470	169	88	0	10501	4592	4592	1.0	4592.0
InterPro_count_0.55_0.01	3654	950	0	163458	171	88	0	10501	4604	4604	1.0	4604.0
InterPro_count_0.55_1	3661	952	0	163449	171	89	0	10501	4613	4613	1.0	4613.0
Pfam_count_0.55_1e-30	2710	270	6	165076	118	28	2	10504	2980	2986	0.9979906229068989	2974.012056262559
Pfam_count_0.55_1e-20	3547	285	6	164224	152	34	2	10501	3832	3838	0.9984366857738406	3826.0093798853572
Pfam_count_0.55_1e-15	3898	301	6	163857	163	37	2	10501	4199	4205	0.9985731272294887	4193.008561236623
Pfam_count_0.55_1e-10	4050	301	6	163705	171	37	2	10501	4351	4357	0.9986229056690383	4345.008262565986
Pfam_count_0.55_1e-05	4228	301	6	163527	180	37	2	10501	4529	4535	0.9986769570011025	4523.007938257993
Pfam_count_0.55_0.01	4240	301	6	163515	182	37	2	10501	4541	4547	0.9986804486474599	4535.007917308115
Pfam_count_0.55_1	4249	301	6	163506	182	37	2	10501	4550	4556	0.9986830553116769	4544.00790166813
eggNOG_count_0.55_1e-30	809	2	10	167241	44	1	4	10508	811	821	0.9878197320341048	801.121802679659
eggNOG_count_0.55_1e-20	1036	2	10	167014	59	1	4	10508	1038	1048	0.9904580152671756	1028.0954198473282
eggNOG_count_0.55_1e-15	1213	2	16	166831	68	1	6	10508	1215	1231	0.9870024370430545	1199.2079610073113
eggNOG_count_0.55_1e-10	1289	2	16	166755	74	1	6	10508	1291	1307	0.9877582249426167	1275.195868400918
eggNOG_count_0.55_1e-05	1369	2	18	166673	79	1	7	10508	1371	1389	0.9870410367170627	1353.233261339093
eggNOG_count_0.55_0.01	1369	2	18	166673	79	1	7	10508	1371	1389	0.9870410367170627	1353.233261339093
eggNOG_count_0.55_1	1369	2	18	166673	79	1	7	10508	1371	1389	0.9870410367170627	1353.233261339093
EC number_count_0.6_1e-30	678	14	50	167320	32	3	6	10507	692	742	0.9326145552560647	645.3692722371968
EC number_count_0.6_1e-20	734	14	74	167240	34	3	8	10507	748	822	0.9099756690997567	680.661800486618
EC number_count_0.6_1e-15	734	14	74	167240	34	3	8	10507	748	822	0.9099756690997567	680.661800486618
EC number_count_0.6_1e-10	734	14	74	167240	34	3	8	10507	748	822	0.9099756690997567	680.661800486618
EC number_count_0.6_1e-05	734	14	74	167240	34	3	8	10507	748	822	0.9099756690997567	680.661800486618
EC number_count_0.6_0.01	734	14	74	167240	34	3	8	10507	748	822	0.9099756690997567	680.661800486618
EC number_count_0.6_1	734	14	74	167240	34	3	8	10507	748	822	0.9099756690997567	680.661800486618
Protein families_count_0.6_1e-30	1474	10	125	166453	65	2	11	10506	1484	1609	0.9223119950279677	1368.7110006215041
Protein families_count_0.6_1e-20	2014	14	160	165874	86	3	14	10505	2028	2188	0.926873857404022	1879.7001828153566
Protein families_count_0.6_1e-15	2219	14	160	165669	92	3	14	10505	2233	2393	0.9331383201002925	2083.6978687839533
Protein families_count_0.6_1e-10	2286	14	160	165602	99	3	14	10505	2300	2460	0.9349593495934959	2150.4065040650407
Protein families_count_0.6_1e-05	2387	14	160	165501	105	3	14	10505	2401	2561	0.9375244045294807	2250.996095275283
Protein families_count_0.6_0.01	2389	14	160	165499	105	3	14	10505	2403	2563	0.9375731564572767	2252.988294966836
Protein families_count_0.6_1	2389	14	160	165499	105	3	14	10505	2403	2563	0.9375731564572767	2252.988294966836
OrthoDB_count_0.6_1e-30	729	0	229	167104	42	0	25	10505	729	958	0.7609603340292276	554.740083507307
OrthoDB_count_0.6_1e-20	1003	0	257	166802	56	0	32	10505	1003	1260	0.796031746031746	798.4198412698412
OrthoDB_count_0.6_1e-15	1109	0	296	166657	60	0	34	10505	1109	1405	0.7893238434163701	875.3601423487544
OrthoDB_count_0.6_1e-10	1144	0	310	166608	64	0	37	10505	1144	1454	0.7867950481430537	900.0935350756534
OrthoDB_count_0.6_1e-05	1203	0	318	166541	67	0	39	10505	1203	1521	0.7909270216962525	951.4852071005918
OrthoDB_count_0.6_0.01	1203	0	318	166541	67	0	39	10505	1203	1521	0.7909270216962525	951.4852071005918
OrthoDB_count_0.6_1	1203	0	318	166541	67	0	39	10505	1203	1521	0.7909270216962525	951.4852071005918
PANTHER_count_0.6_1e-30	1436	434	0	166192	73	51	0	10504	1870	1870	1.0	1870.0
PANTHER_count_0.6_1e-20	1864	575	28	165595	95	65	3	10502	2439	2467	0.9886501824077827	2411.317794892582
PANTHER_count_0.6_1e-15	2009	638	28	165387	103	71	3	10502	2647	2675	0.9895327102803738	2619.2930841121497
PANTHER_count_0.6_1e-10	2059	647	36	165320	107	74	4	10502	2706	2742	0.986870897155361	2670.472647702407
PANTHER_count_0.6_1e-05	2144	665	36	165217	115	75	4	10502	2809	2845	0.9873462214411248	2773.4555360281197
PANTHER_count_0.6_0.01	2148	665	36	165213	116	75	4	10502	2813	2849	0.9873639873639873	2777.4548964548962
PANTHER_count_0.6_1	2149	665	36	165212	116	75	4	10502	2814	2850	0.9873684210526316	2778.4547368421054
InterPro_count_0.6_1e-30	1563	319	0	166180	76	34	0	10504	1882	1882	1.0	1882.0
InterPro_count_0.6_1e-20	2084	395	0	165583	95	46	0	10502	2479	2479	1.0	2479.0
InterPro_count_0.6_1e-15	2226	461	0	165375	100	52	0	10502	2687	2687	1.0	2687.0
InterPro_count_0.6_1e-10	2287	467	0	165308	105	54	0	10502	2754	2754	1.0	2754.0
InterPro_count_0.6_1e-05	2384	473	0	165205	110	57	0	10502	2857	2857	1.0	2857.0
InterPro_count_0.6_0.01	2388	473	0	165201	111	57	0	10502	2861	2861	1.0	2861.0
InterPro_count_0.6_1	2389	473	0	165200	111	57	0	10502	2862	2862	1.0	2862.0
Pfam_count_0.6_1e-30	1711	167	4	166180	81	18	1	10504	1878	1882	0.997874601487779	1874.0085015940488
Pfam_count_0.6_1e-20	2296	179	4	165583	105	23	1	10502	2475	2479	0.9983864461476402	2471.0064542154096
Pfam_count_0.6_1e-15	2503	180	4	165375	112	24	1	10502	2683	2687	0.9985113509490138	2679.005954596204
Pfam_count_0.6_1e-10	2564	180	4	165314	117	24	1	10502	2744	2748	0.9985443959243085	2740.0058224163026
Pfam_count_0.6_1e-05	2667	180	4	165211	124	24	1	10502	2847	2851	0.9985969835145563	2843.005612065942
Pfam_count_0.6_0.01	2671	180	4	165207	125	24	1	10502	2851	2855	0.998598949211909	2847.0056042031524
Pfam_count_0.6_1	2672	180	4	165206	125	24	1	10502	2852	2856	0.9985994397759104	2848.005602240896
eggNOG_count_0.6_1e-30	564	0	2	167496	29	0	1	10508	564	566	0.9964664310954063	562.0070671378091
eggNOG_count_0.6_1e-20	714	0	2	167346	38	0	1	10508	714	716	0.9972067039106145	712.0055865921787
eggNOG_count_0.6_1e-15	802	0	2	167258	41	0	1	10508	802	804	0.9975124378109452	800.0049751243781
eggNOG_count_0.6_1e-10	823	0	2	167237	45	0	1	10508	823	825	0.9975757575757576	821.0048484848485
eggNOG_count_0.6_1e-05	870	0	4	167188	47	0	2	10508	870	874	0.9954233409610984	866.0183066361557
eggNOG_count_0.6_0.01	870	0	4	167188	47	0	2	10508	870	874	0.9954233409610984	866.0183066361557
eggNOG_count_0.6_1	870	0	4	167188	47	0	2	10508	870	874	0.9954233409610984	866.0183066361557
EC number_count_0.65_1e-30	263	8	24	167767	17	1	2	10508	271	295	0.9186440677966101	248.95254237288134
EC number_count_0.65_1e-20	284	8	44	167726	20	1	4	10508	292	336	0.8690476190476191	253.76190476190476
EC number_count_0.65_1e-15	284	8	44	167726	20	1	4	10508	292	336	0.8690476190476191	253.76190476190476
EC number_count_0.65_1e-10	284	8	44	167726	20	1	4	10508	292	336	0.8690476190476191	253.76190476190476
EC number_count_0.65_1e-05	284	8	44	167726	20	1	4	10508	292	336	0.8690476190476191	253.76190476190476
EC number_count_0.65_0.01	284	8	44	167726	20	1	4	10508	292	336	0.8690476190476191	253.76190476190476
EC number_count_0.65_1	284	8	44	167726	20	1	4	10508	292	336	0.8690476190476191	253.76190476190476
Protein families_count_0.65_1e-30	669	0	75	167318	35	0	6	10508	669	744	0.8991935483870968	601.5604838709677
Protein families_count_0.65_1e-20	1009	4	110	166939	46	1	9	10507	1013	1123	0.9020480854853072	913.7747105966163
Protein families_count_0.65_1e-15	1107	4	110	166841	51	1	9	10507	1111	1221	0.9099099099099099	1010.90990990991
Protein families_count_0.65_1e-10	1125	4	110	166823	53	1	9	10507	1129	1239	0.9112187247780468	1028.7659402744148
Protein families_count_0.65_1e-05	1151	4	110	166797	57	1	9	10507	1155	1265	0.9130434782608695	1054.5652173913043
Protein families_count_0.65_0.01	1151	4	110	166797	57	1	9	10507	1155	1265	0.9130434782608695	1054.5652173913043
Protein families_count_0.65_1	1151	4	110	166797	57	1	9	10507	1155	1265	0.9130434782608695	1054.5652173913043
OrthoDB_count_0.65_1e-30	325	0	154	167583	23	0	14	10507	325	479	0.6784968684759917	220.51148225469728
OrthoDB_count_0.65_1e-20	507	0	180	167375	30	0	20	10507	507	687	0.7379912663755459	374.16157205240177
OrthoDB_count_0.65_1e-15	553	0	208	167301	34	0	21	10507	553	761	0.7266754270696452	401.8515111695138
OrthoDB_count_0.65_1e-10	561	0	212	167289	35	0	22	10507	561	773	0.7257438551099612	407.1423027166882
OrthoDB_count_0.65_1e-05	577	0	214	167271	38	0	23	10507	577	791	0.729456384323641	420.89633375474085
OrthoDB_count_0.65_0.01	577	0	214	167271	38	0	23	10507	577	791	0.729456384323641	420.89633375474085
OrthoDB_count_0.65_1	577	0	214	167271	38	0	23	10507	577	791	0.729456384323641	420.89633375474085
PANTHER_count_0.65_1e-30	642	240	0	167180	40	28	0	10506	882	882	1.0	882.0
PANTHER_count_0.65_1e-20	903	344	18	166797	50	38	3	10504	1247	1265	0.9857707509881423	1229.2561264822134
PANTHER_count_0.65_1e-15	959	386	18	166699	55	42	3	10504	1345	1363	0.9867938371239912	1327.237710931768
PANTHER_count_0.65_1e-10	977	386	18	166681	57	42	3	10504	1363	1381	0.9869659666908037	1345.2346125995655
PANTHER_count_0.65_1e-05	999	390	18	166655	61	43	3	10504	1389	1407	0.9872068230277186	1371.230277185501
PANTHER_count_0.65_0.01	999	390	18	166655	61	43	3	10504	1389	1407	0.9872068230277186	1371.230277185501
PANTHER_count_0.65_1	999	390	18	166655	61	43	3	10504	1389	1407	0.9872068230277186	1371.230277185501
InterPro_count_0.65_1e-30	790	92	0	167180	41	15	0	10506	882	882	1.0	882.0
InterPro_count_0.65_1e-20	1133	132	0	166797	52	20	0	10504	1265	1265	1.0	1265.0
InterPro_count_0.65_1e-15	1215	148	0	166699	57	21	0	10504	1363	1363	1.0	1363.0
InterPro_count_0.65_1e-10	1233	148	0	166681	59	21	0	10504	1381	1381	1.0	1381.0
InterPro_count_0.65_1e-05	1257	150	0	166655	63	22	0	10504	1407	1407	1.0	1407.0
InterPro_count_0.65_0.01	1257	150	0	166655	63	22	0	10504	1407	1407	1.0	1407.0
InterPro_count_0.65_1	1257	150	0	166655	63	22	0	10504	1407	1407	1.0	1407.0
Pfam_count_0.65_1e-30	805	77	0	167180	44	8	0	10506	882	882	1.0	882.0
Pfam_count_0.65_1e-20	1180	85	0	166797	56	11	0	10504	1265	1265	1.0	1265.0
Pfam_count_0.65_1e-15	1278	85	0	166699	61	11	0	10504	1363	1363	1.0	1363.0
Pfam_count_0.65_1e-10	1296	85	0	166681	63	11	0	10504	1381	1381	1.0	1381.0
Pfam_count_0.65_1e-05	1322	85	0	166655	67	11	0	10504	1407	1407	1.0	1407.0
Pfam_count_0.65_0.01	1322	85	0	166655	67	11	0	10504	1407	1407	1.0	1407.0
Pfam_count_0.65_1	1322	85	0	166655	67	11	0	10504	1407	1407	1.0	1407.0
eggNOG_count_0.65_1e-30	305	0	0	167757	20	0	0	10508	305	305	1.0	305.0
eggNOG_count_0.65_1e-20	401	0	0	167661	23	0	0	10508	401	401	1.0	401.0
eggNOG_count_0.65_1e-15	427	0	0	167635	26	0	0	10508	427	427	1.0	427.0
eggNOG_count_0.65_1e-10	427	0	0	167635	26	0	0	10508	427	427	1.0	427.0
eggNOG_count_0.65_1e-05	441	0	0	167621	29	0	0	10508	441	441	1.0	441.0
eggNOG_count_0.65_0.01	441	0	0	167621	29	0	0	10508	441	441	1.0	441.0
eggNOG_count_0.65_1	441	0	0	167621	29	0	0	10508	441	441	1.0	441.0
EC number_count_0.7_1e-30	64	0	4	167994	8	0	1	10508	64	68	0.9411764705882353	60.23529411764706
EC number_count_0.7_1e-20	64	0	4	167994	8	0	1	10508	64	68	0.9411764705882353	60.23529411764706
EC number_count_0.7_1e-15	64	0	4	167994	8	0	1	10508	64	68	0.9411764705882353	60.23529411764706
EC number_count_0.7_1e-10	64	0	4	167994	8	0	1	10508	64	68	0.9411764705882353	60.23529411764706
EC number_count_0.7_1e-05	64	0	4	167994	8	0	1	10508	64	68	0.9411764705882353	60.23529411764706
EC number_count_0.7_0.01	64	0	4	167994	8	0	1	10508	64	68	0.9411764705882353	60.23529411764706
EC number_count_0.7_1	64	0	4	167994	8	0	1	10508	64	68	0.9411764705882353	60.23529411764706
Protein families_count_0.7_1e-30	300	0	23	167739	16	0	5	10508	300	323	0.9287925696594427	278.6377708978328
Protein families_count_0.7_1e-20	514	4	47	167497	23	1	6	10507	518	565	0.9168141592920354	474.9097345132743
Protein families_count_0.7_1e-15	536	4	47	167475	24	1	6	10507	540	587	0.919931856899489	496.76320272572406
Protein families_count_0.7_1e-10	542	4	47	167469	24	1	6	10507	546	593	0.9207419898819561	502.72512647554805
Protein families_count_0.7_1e-05	542	4	47	167469	24	1	6	10507	546	593	0.9207419898819561	502.72512647554805
Protein families_count_0.7_0.01	542	4	47	167469	24	1	6	10507	546	593	0.9207419898819561	502.72512647554805
Protein families_count_0.7_1	542	4	47	167469	24	1	6	10507	546	593	0.9207419898819561	502.72512647554805
OrthoDB_count_0.7_1e-30	91	0	118	167853	10	0	8	10507	91	209	0.4354066985645933	39.62200956937799
OrthoDB_count_0.7_1e-20	218	0	140	167704	15	0	13	10507	218	358	0.6089385474860335	132.7486033519553
OrthoDB_count_0.7_1e-15	232	0	140	167690	16	0	13	10507	232	372	0.6236559139784946	144.68817204301075
OrthoDB_count_0.7_1e-10	234	0	140	167688	16	0	13	10507	234	374	0.6256684491978609	146.40641711229947
OrthoDB_count_0.7_1e-05	234	0	140	167688	16	0	13	10507	234	374	0.6256684491978609	146.40641711229947
OrthoDB_count_0.7_0.01	234	0	140	167688	16	0	13	10507	234	374	0.6256684491978609	146.40641711229947
OrthoDB_count_0.7_1	234	0	140	167688	16	0	13	10507	234	374	0.6256684491978609	146.40641711229947
PANTHER_count_0.7_1e-30	271	136	0	167655	23	16	0	10506	407	407	1.0	407.0
PANTHER_count_0.7_1e-20	420	225	6	167411	29	22	2	10505	645	651	0.9907834101382489	639.0552995391705
PANTHER_count_0.7_1e-15	436	231	6	167389	30	23	2	10505	667	673	0.9910846953937593	661.0534918276375
PANTHER_count_0.7_1e-10	442	231	6	167383	30	23	2	10505	673	679	0.9911634756995582	667.0530191458026
PANTHER_count_0.7_1e-05	442	231	6	167383	30	23	2	10505	673	679	0.9911634756995582	667.0530191458026
PANTHER_count_0.7_0.01	442	231	6	167383	30	23	2	10505	673	679	0.9911634756995582	667.0530191458026
PANTHER_count_0.7_1	442	231	6	167383	30	23	2	10505	673	679	0.9911634756995582	667.0530191458026
InterPro_count_0.7_1e-30	378	29	0	167655	24	7	0	10506	407	407	1.0	407.0
InterPro_count_0.7_1e-20	590	61	0	167411	31	9	0	10505	651	651	1.0	651.0
InterPro_count_0.7_1e-15	612	61	0	167389	32	9	0	10505	673	673	1.0	673.0
InterPro_count_0.7_1e-10	618	61	0	167383	32	9	0	10505	679	679	1.0	679.0
InterPro_count_0.7_1e-05	618	61	0	167383	32	9	0	10505	679	679	1.0	679.0
InterPro_count_0.7_0.01	618	61	0	167383	32	9	0	10505	679	679	1.0	679.0
InterPro_count_0.7_1	618	61	0	167383	32	9	0	10505	679	679	1.0	679.0
Pfam_count_0.7_1e-30	375	32	0	167655	24	5	0	10506	407	407	1.0	407.0
Pfam_count_0.7_1e-20	613	38	0	167411	31	7	0	10505	651	651	1.0	651.0
Pfam_count_0.7_1e-15	635	38	0	167389	32	7	0	10505	673	673	1.0	673.0
Pfam_count_0.7_1e-10	641	38	0	167383	32	7	0	10505	679	679	1.0	679.0
Pfam_count_0.7_1e-05	641	38	0	167383	32	7	0	10505	679	679	1.0	679.0
Pfam_count_0.7_0.01	641	38	0	167383	32	7	0	10505	679	679	1.0	679.0
Pfam_count_0.7_1	641	38	0	167383	32	7	0	10505	679	679	1.0	679.0
eggNOG_count_0.7_1e-30	126	0	0	167936	8	0	0	10508	126	126	1.0	126.0
eggNOG_count_0.7_1e-20	175	0	0	167887	10	0	0	10508	175	175	1.0	175.0
eggNOG_count_0.7_1e-15	175	0	0	167887	10	0	0	10508	175	175	1.0	175.0
eggNOG_count_0.7_1e-10	175	0	0	167887	10	0	0	10508	175	175	1.0	175.0
eggNOG_count_0.7_1e-05	175	0	0	167887	10	0	0	10508	175	175	1.0	175.0
eggNOG_count_0.7_0.01	175	0	0	167887	10	0	0	10508	175	175	1.0	175.0
eggNOG_count_0.7_1	175	0	0	167887	10	0	0	10508	175	175	1.0	175.0
