	ALL	1orMORE	CERO	NaN	ALL_TruePositive_query_count	1orMORE_TruePositive_query_count	CERO_FalsePositive_query_count	NaN_query_count	TruePositive	sum_TPFP	precision	TruePositive_x_sum_TPFP
EC number_count_0.0_1e-30	303	8	47	167704	303	8	47	10508	311	358	0.8687150837988827	270.1703910614525
EC number_count_0.0_1e-20	394	10	74	167584	394	10	74	10508	404	478	0.8451882845188284	341.45606694560666
EC number_count_0.0_1e-15	435	10	82	167535	435	10	82	10508	445	527	0.8444022770398482	375.75901328273244
EC number_count_0.0_1e-10	485	10	95	167472	485	10	95	10508	495	590	0.8389830508474576	415.29661016949154
EC number_count_0.0_1e-05	508	10	101	167443	508	10	101	10506	518	619	0.8368336025848142	433.4798061389338
EC number_count_0.0_0.01	509	10	102	167441	509	10	102	10506	519	621	0.8357487922705314	433.7536231884058
EC number_count_0.0_1	509	10	103	167440	509	10	103	10506	519	622	0.8344051446945338	433.05627009646304
Protein families_count_0.0_1e-30	597	5	60	167400	597	5	60	10506	602	662	0.9093655589123867	547.4380664652568
Protein families_count_0.0_1e-20	908	5	84	167065	908	5	84	10505	913	997	0.9157472417251755	836.0772316950853
Protein families_count_0.0_1e-15	1111	5	93	166853	1111	5	93	10505	1116	1209	0.9230769230769231	1030.1538461538462
Protein families_count_0.0_1e-10	1328	6	113	166615	1328	6	113	10505	1334	1447	0.921907394609537	1229.8244644091224
Protein families_count_0.0_1e-05	1489	6	125	166442	1489	6	125	10502	1495	1620	0.9228395061728395	1379.6450617283951
Protein families_count_0.0_0.01	1545	6	135	166376	1545	6	135	10502	1551	1686	0.9199288256227758	1426.8096085409252
Protein families_count_0.0_1	1554	6	156	166346	1554	6	156	10499	1560	1716	0.9090909090909091	1418.1818181818182
OrthoDB_count_0.0_1e-30	478	0	203	167381	478	0	203	10506	478	681	0.7019089574155654	335.5124816446402
OrthoDB_count_0.0_1e-20	766	0	504	166792	766	0	504	10503	766	1270	0.6031496062992125	462.0125984251968
OrthoDB_count_0.0_1e-15	928	0	759	166375	928	0	759	10499	928	1687	0.5500889152341435	510.4825133372852
OrthoDB_count_0.0_1e-10	1056	0	1279	165727	1056	0	1279	10486	1056	2335	0.45224839400428263	477.57430406852245
OrthoDB_count_0.0_1e-05	1123	0	2229	164710	1123	0	2229	10438	1123	3352	0.33502386634844866	376.2318019093079
OrthoDB_count_0.0_0.01	1138	0	3093	163831	1138	0	3093	10349	1138	4231	0.2689671472465138	306.0846135665327
OrthoDB_count_0.0_1	1139	0	3500	163423	1139	0	3500	10267	1139	4639	0.24552705324423368	279.65531364518216
PANTHER_count_0.0_1e-30	832	310	83	166837	832	310	83	10504	1142	1225	0.9322448979591836	1064.6236734693878
PANTHER_count_0.0_1e-20	1357	556	255	165894	1357	556	255	10495	1913	2168	0.882380073800738	1687.993081180812
PANTHER_count_0.0_1e-15	1672	732	389	165269	1672	732	389	10488	2404	2793	0.8607232366630863	2069.1786609380592
PANTHER_count_0.0_1e-10	2000	944	684	164434	2000	944	684	10473	2944	3628	0.8114663726571113	2388.9570011025357
PANTHER_count_0.0_1e-05	2239	1085	1053	163685	2239	1085	1053	10448	3324	4377	0.7594242631939685	2524.3262508567514
PANTHER_count_0.0_0.01	2292	1108	1243	163419	2292	1108	1243	10412	3400	4643	0.7322851604566013	2489.7695455524445
PANTHER_count_0.0_1	2297	1111	1330	163324	2297	1111	1330	10390	3408	4738	0.7192908400168848	2451.3431827775435
InterPro_count_0.0_1e-30	569	652	3	166838	569	652	3	10504	1221	1224	0.9975490196078431	1218.0073529411766
InterPro_count_0.0_1e-20	1012	1140	14	165896	1012	1140	14	10495	2152	2166	0.9935364727608494	2138.090489381348
InterPro_count_0.0_1e-15	1295	1482	34	165251	1295	1482	34	10488	2777	2811	0.9879046602632515	2743.4112415510494
InterPro_count_0.0_1e-10	1665	1963	100	164334	1665	1963	100	10467	3628	3728	0.973175965665236	3530.6824034334763
InterPro_count_0.0_1e-05	1971	2445	299	163347	1971	2445	299	10440	4416	4715	0.9365853658536586	4135.960975609756
InterPro_count_0.0_0.01	2069	2607	569	162817	2069	2607	569	10376	4676	5245	0.8915157292659676	4168.727550047664
InterPro_count_0.0_1	2089	2632	769	162572	2089	2632	769	10332	4721	5490	0.8599271402550092	4059.716029143898
Pfam_count_0.0_1e-30	828	308	12	166914	828	308	12	10505	1136	1148	0.9895470383275261	1124.1254355400697
Pfam_count_0.0_1e-20	1443	488	44	166087	1443	488	44	10497	1931	1975	0.9777215189873417	1887.9802531645569
Pfam_count_0.0_1e-15	1839	600	81	165542	1839	600	81	10490	2439	2520	0.9678571428571429	2360.6035714285713
Pfam_count_0.0_1e-10	2303	748	161	164850	2303	748	161	10478	3051	3212	0.9498754669987547	2898.0700498132005
Pfam_count_0.0_1e-05	2668	846	354	164194	2668	846	354	10460	3514	3868	0.9084798345398138	3192.3981385729057
Pfam_count_0.0_0.01	2777	863	543	163879	2777	863	543	10424	3640	4183	0.8701888596700932	3167.487449199139
Pfam_count_0.0_1	2795	865	675	163727	2795	865	675	10402	3660	4335	0.8442906574394463	3090.1038062283733
eggNOG_count_0.0_1e-30	485	16	65	167496	485	16	65	10506	501	566	0.8851590106007067	443.46466431095405
eggNOG_count_0.0_1e-20	800	29	179	167054	800	29	179	10502	829	1008	0.8224206349206349	681.7867063492063
eggNOG_count_0.0_1e-15	964	32	308	166758	964	32	308	10499	996	1304	0.7638036809815951	760.7484662576687
eggNOG_count_0.0_1e-10	1109	34	578	166341	1109	34	578	10493	1143	1721	0.664148750726322	759.122022080186
eggNOG_count_0.0_1e-05	1175	38	1029	165820	1175	38	1029	10474	1213	2242	0.5410347903657449	656.2752007136485
eggNOG_count_0.0_0.01	1179	38	1399	165446	1179	38	1399	10434	1217	2616	0.46521406727828746	566.1655198776758
eggNOG_count_0.0_1	1180	38	1566	165278	1180	38	1566	10398	1218	2784	0.4375	532.875
EC number_count_0.05_1e-30	303	8	47	167704	303	8	47	10508	311	358	0.8687150837988827	270.1703910614525
EC number_count_0.05_1e-20	394	10	74	167584	394	10	74	10508	404	478	0.8451882845188284	341.45606694560666
EC number_count_0.05_1e-15	435	10	82	167535	435	10	82	10508	445	527	0.8444022770398482	375.75901328273244
EC number_count_0.05_1e-10	485	10	95	167472	485	10	95	10508	495	590	0.8389830508474576	415.29661016949154
EC number_count_0.05_1e-05	508	10	101	167443	508	10	101	10506	518	619	0.8368336025848142	433.4798061389338
EC number_count_0.05_0.01	509	10	102	167441	509	10	102	10506	519	621	0.8357487922705314	433.7536231884058
EC number_count_0.05_1	509	10	103	167440	509	10	103	10506	519	622	0.8344051446945338	433.05627009646304
Protein families_count_0.05_1e-30	597	5	60	167400	597	5	60	10506	602	662	0.9093655589123867	547.4380664652568
Protein families_count_0.05_1e-20	908	5	84	167065	908	5	84	10505	913	997	0.9157472417251755	836.0772316950853
Protein families_count_0.05_1e-15	1111	5	93	166853	1111	5	93	10505	1116	1209	0.9230769230769231	1030.1538461538462
Protein families_count_0.05_1e-10	1328	6	113	166615	1328	6	113	10505	1334	1447	0.921907394609537	1229.8244644091224
Protein families_count_0.05_1e-05	1489	6	125	166442	1489	6	125	10502	1495	1620	0.9228395061728395	1379.6450617283951
Protein families_count_0.05_0.01	1545	6	135	166376	1545	6	135	10502	1551	1686	0.9199288256227758	1426.8096085409252
Protein families_count_0.05_1	1554	6	156	166346	1554	6	156	10499	1560	1716	0.9090909090909091	1418.1818181818182
OrthoDB_count_0.05_1e-30	478	0	203	167381	478	0	203	10506	478	681	0.7019089574155654	335.5124816446402
OrthoDB_count_0.05_1e-20	766	0	504	166792	766	0	504	10503	766	1270	0.6031496062992125	462.0125984251968
OrthoDB_count_0.05_1e-15	928	0	759	166375	928	0	759	10499	928	1687	0.5500889152341435	510.4825133372852
OrthoDB_count_0.05_1e-10	1056	0	1279	165727	1056	0	1279	10486	1056	2335	0.45224839400428263	477.57430406852245
OrthoDB_count_0.05_1e-05	1123	0	2229	164710	1123	0	2229	10438	1123	3352	0.33502386634844866	376.2318019093079
OrthoDB_count_0.05_0.01	1138	0	3093	163831	1138	0	3093	10349	1138	4231	0.2689671472465138	306.0846135665327
OrthoDB_count_0.05_1	1139	0	3499	163424	1139	0	3499	10267	1139	4638	0.24557999137559292	279.71561017680034
PANTHER_count_0.05_1e-30	832	310	83	166837	832	310	83	10504	1142	1225	0.9322448979591836	1064.6236734693878
PANTHER_count_0.05_1e-20	1357	556	255	165894	1357	556	255	10495	1913	2168	0.882380073800738	1687.993081180812
PANTHER_count_0.05_1e-15	1672	732	389	165269	1672	732	389	10488	2404	2793	0.8607232366630863	2069.1786609380592
PANTHER_count_0.05_1e-10	2000	944	684	164434	2000	944	684	10473	2944	3628	0.8114663726571113	2388.9570011025357
PANTHER_count_0.05_1e-05	2239	1085	1053	163685	2239	1085	1053	10448	3324	4377	0.7594242631939685	2524.3262508567514
PANTHER_count_0.05_0.01	2292	1108	1243	163419	2292	1108	1243	10412	3400	4643	0.7322851604566013	2489.7695455524445
PANTHER_count_0.05_1	2297	1111	1330	163324	2297	1111	1330	10390	3408	4738	0.7192908400168848	2451.3431827775435
InterPro_count_0.05_1e-30	569	652	3	166838	569	652	3	10504	1221	1224	0.9975490196078431	1218.0073529411766
InterPro_count_0.05_1e-20	1012	1140	14	165896	1012	1140	14	10495	2152	2166	0.9935364727608494	2138.090489381348
InterPro_count_0.05_1e-15	1295	1482	34	165251	1295	1482	34	10488	2777	2811	0.9879046602632515	2743.4112415510494
InterPro_count_0.05_1e-10	1665	1963	100	164334	1665	1963	100	10467	3628	3728	0.973175965665236	3530.6824034334763
InterPro_count_0.05_1e-05	1971	2445	299	163347	1971	2445	299	10440	4416	4715	0.9365853658536586	4135.960975609756
InterPro_count_0.05_0.01	2069	2607	569	162817	2069	2607	569	10376	4676	5245	0.8915157292659676	4168.727550047664
InterPro_count_0.05_1	2089	2632	768	162573	2089	2632	768	10332	4721	5489	0.8600838039715796	4060.455638549827
Pfam_count_0.05_1e-30	828	308	12	166914	828	308	12	10505	1136	1148	0.9895470383275261	1124.1254355400697
Pfam_count_0.05_1e-20	1443	488	44	166087	1443	488	44	10497	1931	1975	0.9777215189873417	1887.9802531645569
Pfam_count_0.05_1e-15	1839	600	81	165542	1839	600	81	10490	2439	2520	0.9678571428571429	2360.6035714285713
Pfam_count_0.05_1e-10	2303	748	161	164850	2303	748	161	10478	3051	3212	0.9498754669987547	2898.0700498132005
Pfam_count_0.05_1e-05	2668	846	354	164194	2668	846	354	10460	3514	3868	0.9084798345398138	3192.3981385729057
Pfam_count_0.05_0.01	2777	863	543	163879	2777	863	543	10424	3640	4183	0.8701888596700932	3167.487449199139
Pfam_count_0.05_1	2795	865	675	163727	2795	865	675	10402	3660	4335	0.8442906574394463	3090.1038062283733
eggNOG_count_0.05_1e-30	485	16	65	167496	485	16	65	10506	501	566	0.8851590106007067	443.46466431095405
eggNOG_count_0.05_1e-20	800	29	179	167054	800	29	179	10502	829	1008	0.8224206349206349	681.7867063492063
eggNOG_count_0.05_1e-15	964	32	308	166758	964	32	308	10499	996	1304	0.7638036809815951	760.7484662576687
eggNOG_count_0.05_1e-10	1109	34	578	166341	1109	34	578	10493	1143	1721	0.664148750726322	759.122022080186
eggNOG_count_0.05_1e-05	1175	38	1029	165820	1175	38	1029	10474	1213	2242	0.5410347903657449	656.2752007136485
eggNOG_count_0.05_0.01	1179	38	1399	165446	1179	38	1399	10434	1217	2616	0.46521406727828746	566.1655198776758
eggNOG_count_0.05_1	1180	38	1566	165278	1180	38	1566	10398	1218	2784	0.4375	532.875
EC number_count_0.1_1e-30	303	8	47	167704	303	8	47	10508	311	358	0.8687150837988827	270.1703910614525
EC number_count_0.1_1e-20	394	10	74	167584	394	10	74	10508	404	478	0.8451882845188284	341.45606694560666
EC number_count_0.1_1e-15	435	10	82	167535	435	10	82	10508	445	527	0.8444022770398482	375.75901328273244
EC number_count_0.1_1e-10	485	10	95	167472	485	10	95	10508	495	590	0.8389830508474576	415.29661016949154
EC number_count_0.1_1e-05	507	10	100	167445	507	10	100	10506	517	617	0.8379254457050244	433.2074554294976
EC number_count_0.1_0.01	508	10	101	167443	508	10	101	10506	518	619	0.8368336025848142	433.4798061389338
EC number_count_0.1_1	508	10	102	167442	508	10	102	10506	518	620	0.8354838709677419	432.7806451612903
Protein families_count_0.1_1e-30	597	5	60	167400	597	5	60	10506	602	662	0.9093655589123867	547.4380664652568
Protein families_count_0.1_1e-20	908	5	84	167065	908	5	84	10505	913	997	0.9157472417251755	836.0772316950853
Protein families_count_0.1_1e-15	1111	5	92	166854	1111	5	92	10505	1116	1208	0.9238410596026491	1031.0066225165563
Protein families_count_0.1_1e-10	1327	6	112	166617	1327	6	112	10505	1333	1445	0.9224913494809689	1229.6809688581316
Protein families_count_0.1_1e-05	1486	6	121	166449	1486	6	121	10503	1492	1613	0.9249845009299442	1380.0768753874768
Protein families_count_0.1_0.01	1541	6	131	166384	1541	6	131	10503	1547	1678	0.9219308700834327	1426.2270560190702
Protein families_count_0.1_1	1550	6	149	166357	1550	6	149	10500	1556	1705	0.9126099706744868	1420.0211143695014
OrthoDB_count_0.1_1e-30	478	0	201	167383	478	0	201	10506	478	679	0.7039764359351989	336.5007363770251
OrthoDB_count_0.1_1e-20	766	0	495	166801	766	0	495	10503	766	1261	0.6074544012688342	465.310071371927
OrthoDB_count_0.1_1e-15	928	0	738	166396	928	0	738	10499	928	1666	0.5570228091236494	516.9171668667467
OrthoDB_count_0.1_1e-10	1056	0	1232	165774	1056	0	1232	10488	1056	2288	0.46153846153846156	487.3846153846154
OrthoDB_count_0.1_1e-05	1123	0	2080	164859	1123	0	2080	10444	1123	3203	0.35060880424601937	393.73368716827974
OrthoDB_count_0.1_0.01	1137	0	2825	164100	1137	0	2825	10370	1137	3962	0.28697627460878344	326.29202423018677
OrthoDB_count_0.1_1	1138	0	3176	163748	1138	0	3176	10297	1138	4314	0.26379230412610105	300.195642095503
PANTHER_count_0.1_1e-30	832	310	82	166838	832	310	82	10504	1142	1224	0.9330065359477124	1065.4934640522877
PANTHER_count_0.1_1e-20	1356	556	249	165901	1356	556	249	10495	1912	2161	0.8847755668671912	1691.6908838500694
PANTHER_count_0.1_1e-15	1671	729	380	165282	1671	729	380	10488	2400	2780	0.8633093525179856	2071.9424460431655
PANTHER_count_0.1_1e-10	1997	939	654	164472	1997	939	654	10475	2936	3590	0.8178272980501393	2401.140947075209
PANTHER_count_0.1_1e-05	2236	1077	979	163770	2236	1077	979	10451	3313	4292	0.7719012115563839	2557.3087138862998
PANTHER_count_0.1_0.01	2288	1100	1135	163539	2288	1100	1135	10420	3388	4523	0.7490603581693567	2537.8164934777806
PANTHER_count_0.1_1	2293	1103	1204	163462	2293	1103	1204	10398	3396	4600	0.7382608695652174	2507.1339130434785
InterPro_count_0.1_1e-30	569	650	3	166840	569	650	3	10504	1219	1222	0.997545008183306	1216.0073649754502
InterPro_count_0.1_1e-20	1012	1136	11	165903	1012	1136	11	10495	2148	2159	0.9949050486336267	2137.05604446503
InterPro_count_0.1_1e-15	1295	1475	29	165263	1295	1475	29	10488	2770	2799	0.9896391568417292	2741.30046445159
InterPro_count_0.1_1e-10	1663	1941	81	164377	1663	1941	81	10469	3604	3685	0.9780189959294436	3524.780461329715
InterPro_count_0.1_1e-05	1963	2391	233	163475	1963	2391	233	10447	4354	4587	0.9492042729452801	4132.83540440375
InterPro_count_0.1_0.01	2059	2545	434	163024	2059	2545	434	10397	4604	5038	0.9138547042477173	4207.38705835649
InterPro_count_0.1_1	2079	2567	597	162819	2079	2567	597	10356	4646	5243	0.8861338928094602	4116.978065992752
Pfam_count_0.1_1e-30	828	307	12	166915	828	307	12	10505	1135	1147	0.9895379250217959	1123.1255448997383
Pfam_count_0.1_1e-20	1442	487	43	166090	1442	487	43	10497	1929	1972	0.9781947261663286	1886.937626774848
Pfam_count_0.1_1e-15	1838	599	79	165546	1838	599	79	10490	2437	2516	0.9686009538950715	2360.4805246422893
Pfam_count_0.1_1e-10	2301	744	149	164868	2301	744	149	10479	3045	3194	0.9533500313087038	2902.950845335003
Pfam_count_0.1_1e-05	2665	839	306	164252	2665	839	306	10464	3504	3810	0.9196850393700787	3222.576377952756
Pfam_count_0.1_0.01	2773	856	453	163980	2773	856	453	10437	3629	4082	0.8890249877511024	3226.2716805487507
Pfam_count_0.1_1	2790	858	569	163845	2790	858	569	10415	3648	4217	0.8650699549442732	3155.7751956367088
eggNOG_count_0.1_1e-30	485	16	63	167498	485	16	63	10506	501	564	0.8882978723404256	445.0372340425532
eggNOG_count_0.1_1e-20	800	29	172	167061	800	29	172	10502	829	1001	0.8281718281718282	686.5544455544456
eggNOG_count_0.1_1e-15	964	32	294	166772	964	32	294	10499	996	1290	0.772093023255814	769.0046511627908
eggNOG_count_0.1_1e-10	1109	34	546	166373	1109	34	546	10493	1143	1689	0.6767317939609236	773.5044404973357
eggNOG_count_0.1_1e-05	1175	38	946	165903	1175	38	946	10476	1213	2159	0.5618341824918944	681.504863362668
eggNOG_count_0.1_0.01	1179	38	1271	165574	1179	38	1271	10443	1217	2488	0.4891479099678457	595.2930064308682
eggNOG_count_0.1_1	1180	38	1414	165430	1180	38	1414	10409	1218	2632	0.4627659574468085	563.6489361702128
EC number_count_0.15_1e-30	302	8	47	167705	302	8	47	10508	310	357	0.8683473389355743	269.18767507002804
EC number_count_0.15_1e-20	386	10	73	167593	386	10	73	10508	396	469	0.8443496801705757	334.36247334754796
EC number_count_0.15_1e-15	424	10	78	167550	424	10	78	10508	434	512	0.84765625	367.8828125
EC number_count_0.15_1e-10	469	10	86	167497	469	10	86	10508	479	565	0.8477876106194691	406.0902654867257
EC number_count_0.15_1e-05	482	10	88	167482	482	10	88	10508	492	580	0.8482758620689655	417.35172413793106
EC number_count_0.15_0.01	482	10	88	167482	482	10	88	10508	492	580	0.8482758620689655	417.35172413793106
EC number_count_0.15_1	482	10	89	167481	482	10	89	10508	492	581	0.846815834767642	416.63339070567986
Protein families_count_0.15_1e-30	588	5	60	167409	588	5	60	10506	593	653	0.9081163859111792	538.5130168453293
Protein families_count_0.15_1e-20	875	5	82	167100	875	5	82	10505	880	962	0.9147609147609148	804.989604989605
Protein families_count_0.15_1e-15	1064	5	87	166906	1064	5	87	10505	1069	1156	0.9247404844290658	988.5475778546713
Protein families_count_0.15_1e-10	1261	6	95	166700	1261	6	95	10505	1267	1362	0.9302496328928047	1178.6262848751835
Protein families_count_0.15_1e-05	1393	6	101	166562	1393	6	101	10505	1399	1500	0.9326666666666666	1304.8006666666665
Protein families_count_0.15_0.01	1442	6	104	166510	1442	6	104	10505	1448	1552	0.9329896907216495	1350.9690721649486
Protein families_count_0.15_1	1451	6	110	166495	1451	6	110	10503	1457	1567	0.9298021697511167	1354.7217613273772
OrthoDB_count_0.15_1e-30	473	0	169	167420	473	0	169	10507	473	642	0.7367601246105919	348.48753894081
OrthoDB_count_0.15_1e-20	749	0	385	166928	749	0	385	10504	749	1134	0.6604938271604939	494.70987654320993
OrthoDB_count_0.15_1e-15	902	0	532	166628	902	0	532	10502	902	1434	0.6290097629009763	567.3668061366807
OrthoDB_count_0.15_1e-10	1025	0	773	166264	1025	0	773	10499	1025	1798	0.5700778642936596	584.3298109010011
OrthoDB_count_0.15_1e-05	1084	0	1056	165922	1084	0	1056	10490	1084	2140	0.5065420560747663	549.0915887850467
OrthoDB_count_0.15_0.01	1098	0	1230	165734	1098	0	1230	10479	1098	2328	0.47164948453608246	517.8711340206186
OrthoDB_count_0.15_1	1099	0	1357	165606	1099	0	1357	10458	1099	2456	0.44747557003257327	491.77565146579803
PANTHER_count_0.15_1e-30	809	299	66	166888	809	299	66	10505	1108	1174	0.9437819420783645	1045.710391822828
PANTHER_count_0.15_1e-20	1289	516	181	166076	1289	516	181	10497	1805	1986	0.9088620342396777	1640.4959718026182
PANTHER_count_0.15_1e-15	1571	661	250	165580	1571	661	250	10493	2232	2482	0.8992747784045125	2007.181305398872
PANTHER_count_0.15_1e-10	1852	827	372	165011	1852	827	372	10487	2679	3051	0.8780727630285152	2352.3569321533923
PANTHER_count_0.15_1e-05	2048	932	476	164606	2048	932	476	10477	2980	3456	0.8622685185185185	2569.560185185185
PANTHER_count_0.15_0.01	2091	952	513	164506	2091	952	513	10469	3043	3556	0.8557367829021373	2604.0070303712037
PANTHER_count_0.15_1	2096	955	529	164482	2096	955	529	10465	3051	3580	0.8522346368715084	2600.167877094972
InterPro_count_0.15_1e-30	561	612	1	166888	561	612	1	10505	1173	1174	0.9991482112436116	1172.0008517887566
InterPro_count_0.15_1e-20	975	1005	4	166078	975	1005	4	10497	1980	1984	0.9979838709677419	1976.008064516129
InterPro_count_0.15_1e-15	1225	1260	6	165571	1225	1260	6	10493	2485	2491	0.997591328783621	2479.0144520272984
InterPro_count_0.15_1e-10	1541	1545	11	164965	1541	1545	11	10484	3086	3097	0.9964481756538586	3075.0390700678076
InterPro_count_0.15_1e-05	1788	1782	29	164463	1788	1782	29	10473	3570	3599	0.9919422061683801	3541.233676021117
InterPro_count_0.15_0.01	1863	1856	53	164290	1863	1856	53	10460	3719	3772	0.985949098621421	3666.7446977730647
InterPro_count_0.15_1	1880	1871	94	164217	1880	1871	94	10446	3751	3845	0.9755526657997399	3659.298049414824
Pfam_count_0.15_1e-30	816	293	11	166942	816	293	11	10506	1109	1120	0.9901785714285715	1098.1080357142857
Pfam_count_0.15_1e-20	1386	434	33	166209	1386	434	33	10498	1820	1853	0.9821910415542364	1787.5876956287102
Pfam_count_0.15_1e-15	1733	518	53	165758	1733	518	53	10494	2251	2304	0.9769965277777778	2199.219184027778
Pfam_count_0.15_1e-10	2129	620	75	165238	2129	620	75	10489	2749	2824	0.9734419263456091	2675.9918555240793
Pfam_count_0.15_1e-05	2420	676	122	164844	2420	676	122	10481	3096	3218	0.9620882535736482	2978.625233064015
Pfam_count_0.15_0.01	2507	684	146	164725	2507	684	146	10474	3191	3337	0.9562481270602338	3051.3877734492057
Pfam_count_0.15_1	2523	686	179	164674	2523	686	179	10465	3209	3388	0.9471664698937426	3039.4572018890203
eggNOG_count_0.15_1e-30	472	14	40	167536	472	14	40	10506	486	526	0.9239543726235742	449.04182509505705
eggNOG_count_0.15_1e-20	764	25	100	167173	764	25	100	10503	789	889	0.8875140607424072	700.2485939257593
eggNOG_count_0.15_1e-15	922	28	165	166947	922	28	165	10501	950	1115	0.852017937219731	809.4170403587444
eggNOG_count_0.15_1e-10	1056	29	268	166709	1056	29	268	10500	1085	1353	0.8019216555801921	870.0849963045084
eggNOG_count_0.15_1e-05	1115	32	412	166503	1115	32	412	10497	1147	1559	0.7357280307889673	843.8800513149455
eggNOG_count_0.15_0.01	1119	32	505	166406	1119	32	505	10491	1151	1656	0.6950483091787439	800.0006038647343
eggNOG_count_0.15_1	1120	32	550	166360	1120	32	550	10482	1152	1702	0.6768507638072856	779.732079905993
EC number_count_0.2_1e-30	289	8	45	167720	289	8	45	10508	297	342	0.868421052631579	257.92105263157896
EC number_count_0.2_1e-20	367	9	64	167622	367	9	64	10508	376	440	0.8545454545454545	321.3090909090909
EC number_count_0.2_1e-15	394	9	68	167591	394	9	68	10508	403	471	0.8556263269639066	344.8174097664544
EC number_count_0.2_1e-10	426	9	71	167556	426	9	71	10508	435	506	0.8596837944664032	373.9624505928854
EC number_count_0.2_1e-05	434	9	73	167546	434	9	73	10508	443	516	0.8585271317829457	380.32751937984494
EC number_count_0.2_0.01	434	9	73	167546	434	9	73	10508	443	516	0.8585271317829457	380.32751937984494
EC number_count_0.2_1	434	9	73	167546	434	9	73	10508	443	516	0.8585271317829457	380.32751937984494
Protein families_count_0.2_1e-30	547	5	54	167456	547	5	54	10507	552	606	0.9108910891089109	502.81188118811883
Protein families_count_0.2_1e-20	786	5	72	167199	786	5	72	10506	791	863	0.9165701042873696	725.0069524913093
Protein families_count_0.2_1e-15	923	5	74	167060	923	5	74	10506	928	1002	0.9261477045908184	859.4650698602795
Protein families_count_0.2_1e-10	1070	6	81	166905	1070	6	81	10506	1076	1157	0.9299913569576491	1000.6707000864304
Protein families_count_0.2_1e-05	1161	6	83	166812	1161	6	83	10506	1167	1250	0.9336	1089.5112
Protein families_count_0.2_0.01	1193	6	84	166779	1193	6	84	10506	1199	1283	0.9345284489477786	1120.4996102883865
Protein families_count_0.2_1	1200	6	86	166770	1200	6	86	10504	1206	1292	0.93343653250774	1125.7244582043343
OrthoDB_count_0.2_1e-30	440	0	125	167497	440	0	125	10508	440	565	0.7787610619469026	342.65486725663715
OrthoDB_count_0.2_1e-20	672	0	238	167152	672	0	238	10505	672	910	0.7384615384615385	496.2461538461539
OrthoDB_count_0.2_1e-15	799	0	302	166961	799	0	302	10503	799	1101	0.7257039055404177	579.8374205267938
OrthoDB_count_0.2_1e-10	901	0	406	166755	901	0	406	10502	901	1307	0.6893649579188983	621.1178270849274
OrthoDB_count_0.2_1e-05	943	0	499	166620	943	0	499	10501	943	1442	0.6539528432732317	616.6775312066575
OrthoDB_count_0.2_0.01	954	0	547	166561	954	0	547	10501	954	1501	0.6355762824783477	606.3397734843437
OrthoDB_count_0.2_1	955	0	572	166535	955	0	572	10498	955	1527	0.6254092992796333	597.2658808120498
PANTHER_count_0.2_1e-30	748	262	44	167008	748	262	44	10507	1010	1054	0.9582542694497154	967.8368121442126
PANTHER_count_0.2_1e-20	1126	404	101	166431	1126	404	101	10502	1530	1631	0.9380748007357449	1435.2544451256897
PANTHER_count_0.2_1e-15	1324	494	123	166121	1324	494	123	10499	1818	1941	0.9366306027820711	1702.7944358578052
PANTHER_count_0.2_1e-10	1522	590	169	165781	1522	590	169	10497	2112	2281	0.9259096887330118	1955.521262604121
PANTHER_count_0.2_1e-05	1638	653	202	165569	1638	653	202	10492	2291	2493	0.918973124749298	2105.367428800642
PANTHER_count_0.2_0.01	1666	665	210	165521	1666	665	210	10492	2331	2541	0.9173553719008265	2138.3553719008264
PANTHER_count_0.2_1	1670	668	216	165508	1670	668	216	10489	2338	2554	0.9154267815191856	2140.267815191856
InterPro_count_0.2_1e-30	538	515	1	167008	538	515	1	10507	1053	1054	0.9990512333965844	1052.0009487666034
InterPro_count_0.2_1e-20	874	749	4	166435	874	749	4	10502	1623	1627	0.9975414874001229	1619.0098340503996
InterPro_count_0.2_1e-15	1052	886	5	166119	1052	886	5	10499	1938	1943	0.9974266598044261	1933.0128667009778
InterPro_count_0.2_1e-10	1257	1030	8	165767	1257	1030	8	10497	2287	2295	0.9965141612200435	2279.0278867102397
InterPro_count_0.2_1e-05	1399	1127	9	165527	1399	1127	9	10492	2526	2535	0.9964497041420118	2517.031952662722
InterPro_count_0.2_0.01	1446	1155	11	165450	1446	1155	11	10491	2601	2612	0.9957886676875957	2590.0463246554364
InterPro_count_0.2_1	1460	1165	20	165417	1460	1165	20	10482	2625	2645	0.9924385633270322	2605.1512287334594
Pfam_count_0.2_1e-30	767	239	11	167045	767	239	11	10507	1006	1017	0.9891838741396264	995.1189773844642
Pfam_count_0.2_1e-20	1208	323	26	166505	1208	323	26	10502	1531	1557	0.98330122029544	1505.4341682723186
Pfam_count_0.2_1e-15	1450	365	36	166211	1450	365	36	10499	1815	1851	0.9805510534846029	1779.7001620745543
Pfam_count_0.2_1e-10	1715	412	46	165889	1715	412	46	10498	2127	2173	0.9788311090658076	2081.9737689829726
Pfam_count_0.2_1e-05	1892	432	53	165685	1892	432	53	10493	2324	2377	0.9777029869583509	2272.1817416912077
Pfam_count_0.2_0.01	1944	433	59	165626	1944	433	59	10493	2377	2436	0.9757799671592775	2319.4289819376027
Pfam_count_0.2_1	1958	435	68	165601	1958	435	68	10487	2393	2461	0.9723689557090613	2326.8789110117837
eggNOG_count_0.2_1e-30	423	11	27	167601	423	11	27	10507	434	461	0.9414316702819957	408.58134490238615
eggNOG_count_0.2_1e-20	642	21	55	167344	642	21	55	10504	663	718	0.9233983286908078	612.2130919220056
eggNOG_count_0.2_1e-15	761	22	73	167206	761	22	73	10502	783	856	0.9147196261682243	716.2254672897196
eggNOG_count_0.2_1e-10	864	22	98	167078	864	22	98	10502	886	984	0.9004065040650406	797.760162601626
eggNOG_count_0.2_1e-05	909	23	148	166982	909	23	148	10502	932	1080	0.8629629629629629	804.2814814814815
eggNOG_count_0.2_0.01	912	23	178	166949	912	23	178	10501	935	1113	0.8400718778077269	785.4672057502246
eggNOG_count_0.2_1	913	23	190	166936	913	23	190	10498	936	1126	0.8312611012433393	778.0603907637656
EC number_count_0.25_1e-30	261	8	39	167754	261	8	39	10508	269	308	0.8733766233766234	234.93831168831167
EC number_count_0.25_1e-20	320	8	51	167683	320	8	51	10508	328	379	0.8654353562005277	283.8627968337731
EC number_count_0.25_1e-15	340	8	52	167662	340	8	52	10508	348	400	0.87	302.76
EC number_count_0.25_1e-10	359	8	54	167641	359	8	54	10508	367	421	0.8717339667458432	319.92636579572445
EC number_count_0.25_1e-05	365	8	55	167634	365	8	55	10508	373	428	0.8714953271028038	325.0677570093458
EC number_count_0.25_0.01	365	8	55	167634	365	8	55	10508	373	428	0.8714953271028038	325.0677570093458
EC number_count_0.25_1	365	8	55	167634	365	8	55	10508	373	428	0.8714953271028038	325.0677570093458
Protein families_count_0.25_1e-30	475	4	45	167538	475	4	45	10508	479	524	0.9141221374045801	437.8645038167939
Protein families_count_0.25_1e-20	646	4	56	167356	646	4	56	10507	650	706	0.9206798866855525	598.4419263456091
Protein families_count_0.25_1e-15	749	4	57	167252	749	4	57	10507	753	810	0.9296296296296296	700.0111111111111
Protein families_count_0.25_1e-10	846	4	63	167149	846	4	63	10507	850	913	0.9309967141292442	791.3472070098576
Protein families_count_0.25_1e-05	910	4	65	167083	910	4	65	10507	914	979	0.933605720122574	853.3156281920327
Protein families_count_0.25_0.01	927	4	66	167065	927	4	66	10507	931	997	0.9338014042126379	869.3691073219659
Protein families_count_0.25_1	932	4	66	167060	932	4	66	10507	936	1002	0.9341317365269461	874.3473053892216
OrthoDB_count_0.25_1e-30	360	0	81	167621	360	0	81	10508	360	441	0.8163265306122449	293.8775510204082
OrthoDB_count_0.25_1e-20	518	0	123	167421	518	0	123	10507	518	641	0.8081123244929798	418.6021840873635
OrthoDB_count_0.25_1e-15	600	0	150	167312	600	0	150	10506	600	750	0.8	480.0
OrthoDB_count_0.25_1e-10	679	0	194	167189	679	0	194	10505	679	873	0.7777777777777778	528.1111111111111
OrthoDB_count_0.25_1e-05	711	0	235	167116	711	0	235	10504	711	946	0.7515856236786469	534.3773784355179
OrthoDB_count_0.25_0.01	721	0	245	167096	721	0	245	10504	721	966	0.7463768115942029	538.1376811594203
OrthoDB_count_0.25_1	722	0	253	167087	722	0	253	10503	722	975	0.7405128205128205	534.6502564102565
PANTHER_count_0.25_1e-30	621	208	23	167210	621	208	23	10508	829	852	0.9730046948356808	806.6208920187794
PANTHER_count_0.25_1e-20	868	283	46	166865	868	283	46	10506	1151	1197	0.9615705931495405	1106.767752715121
PANTHER_count_0.25_1e-15	984	338	55	166685	984	338	55	10505	1322	1377	0.9600580973129993	1269.196804647785
PANTHER_count_0.25_1e-10	1108	390	69	166495	1108	390	69	10504	1498	1567	0.955966815571155	1432.0382897255902
PANTHER_count_0.25_1e-05	1180	431	85	166366	1180	431	85	10502	1611	1696	0.9498820754716981	1530.2600235849056
PANTHER_count_0.25_0.01	1197	435	87	166343	1197	435	87	10502	1632	1719	0.9493891797556719	1549.4031413612565
PANTHER_count_0.25_1	1200	436	88	166338	1200	436	88	10501	1636	1724	0.9489559164733179	1552.491879350348
InterPro_count_0.25_1e-30	474	378	0	167210	474	378	0	10508	852	852	1.0	852.0
InterPro_count_0.25_1e-20	702	489	2	166869	702	489	2	10506	1191	1193	0.9983235540653814	1189.0033528918693
InterPro_count_0.25_1e-15	812	564	3	166683	812	564	3	10505	1376	1379	0.9978245105148659	1373.0065264684554
InterPro_count_0.25_1e-10	935	634	4	166489	935	634	4	10504	1569	1573	0.9974570883661793	1565.0101716465354
InterPro_count_0.25_1e-05	1020	681	5	166356	1020	681	5	10502	1701	1706	0.9970691676436108	1696.014654161782
InterPro_count_0.25_0.01	1044	691	5	166322	1044	691	5	10502	1735	1740	0.9971264367816092	1730.0143678160919
InterPro_count_0.25_1	1054	694	7	166307	1054	694	7	10498	1748	1755	0.996011396011396	1741.0279202279203
Pfam_count_0.25_1e-30	659	166	9	167228	659	166	9	10508	825	834	0.9892086330935251	816.0971223021583
Pfam_count_0.25_1e-20	949	203	16	166894	949	203	16	10506	1152	1168	0.9863013698630136	1136.2191780821918
Pfam_count_0.25_1e-15	1098	227	21	166716	1098	227	21	10505	1325	1346	0.9843982169390788	1304.3276374442794
Pfam_count_0.25_1e-10	1259	245	25	166533	1259	245	25	10504	1504	1529	0.9836494440810988	1479.4087638979727
Pfam_count_0.25_1e-05	1363	257	28	166414	1363	257	28	10502	1620	1648	0.9830097087378641	1592.4757281553398
Pfam_count_0.25_0.01	1392	257	29	166384	1392	257	29	10502	1649	1678	0.9827175208581644	1620.5011918951132
Pfam_count_0.25_1	1401	258	30	166373	1401	258	30	10500	1659	1689	0.9822380106571936	1629.5328596802842
eggNOG_count_0.25_1e-30	328	7	14	167713	328	7	14	10508	335	349	0.9598853868194842	321.56160458452723
eggNOG_count_0.25_1e-20	464	11	25	167562	464	11	25	10507	475	500	0.95	451.25
eggNOG_count_0.25_1e-15	543	12	30	167477	543	12	30	10506	555	585	0.9487179487179487	526.5384615384615
eggNOG_count_0.25_1e-10	613	12	36	167401	613	12	36	10506	625	661	0.9455370650529501	590.9606656580938
eggNOG_count_0.25_1e-05	650	13	54	167345	650	13	54	10506	663	717	0.9246861924686193	613.0669456066946
eggNOG_count_0.25_0.01	652	13	62	167335	652	13	62	10506	665	727	0.9147180192572214	608.2874828060523
eggNOG_count_0.25_1	653	13	67	167329	653	13	67	10506	666	733	0.9085948158253752	605.1241473396999
EC number_count_0.3_1e-30	224	7	32	167799	224	7	32	10508	231	263	0.8783269961977186	202.89353612167298
EC number_count_0.3_1e-20	264	7	42	167749	264	7	42	10508	271	313	0.865814696485623	234.63578274760386
EC number_count_0.3_1e-15	276	7	43	167736	276	7	43	10508	283	326	0.8680981595092024	245.67177914110428
EC number_count_0.3_1e-10	287	7	44	167724	287	7	44	10508	294	338	0.8698224852071006	255.72781065088756
EC number_count_0.3_1e-05	289	7	45	167721	289	7	45	10508	296	341	0.8680351906158358	256.9384164222874
EC number_count_0.3_0.01	289	7	45	167721	289	7	45	10508	296	341	0.8680351906158358	256.9384164222874
EC number_count_0.3_1	289	7	45	167721	289	7	45	10508	296	341	0.8680351906158358	256.9384164222874
Protein families_count_0.3_1e-30	397	4	37	167624	397	4	37	10508	401	438	0.9155251141552512	367.1255707762557
Protein families_count_0.3_1e-20	530	4	43	167485	530	4	43	10507	534	577	0.925476603119584	494.20450606585786
Protein families_count_0.3_1e-15	601	4	43	167414	601	4	43	10507	605	648	0.933641975308642	564.8533950617284
Protein families_count_0.3_1e-10	669	4	45	167344	669	4	45	10507	673	718	0.9373259052924791	630.8203342618384
Protein families_count_0.3_1e-05	709	4	46	167303	709	4	46	10507	713	759	0.9393939393939394	669.7878787878789
Protein families_count_0.3_0.01	719	4	46	167293	719	4	46	10507	723	769	0.9401820546163849	679.7516254876463
Protein families_count_0.3_1	722	4	46	167290	722	4	46	10507	726	772	0.9404145077720207	682.7409326424871
OrthoDB_count_0.3_1e-30	279	0	56	167727	279	0	56	10508	279	335	0.8328358208955224	232.36119402985076
OrthoDB_count_0.3_1e-20	389	0	78	167595	389	0	78	10507	389	467	0.8329764453961456	324.02783725910064
OrthoDB_count_0.3_1e-15	446	0	88	167528	446	0	88	10507	446	534	0.8352059925093633	372.50187265917606
OrthoDB_count_0.3_1e-10	501	0	111	167450	501	0	111	10507	501	612	0.8186274509803921	410.13235294117646
OrthoDB_count_0.3_1e-05	525	0	125	167412	525	0	125	10507	525	650	0.8076923076923077	424.03846153846155
OrthoDB_count_0.3_0.01	534	0	129	167399	534	0	129	10507	534	663	0.8054298642533937	430.0995475113122
OrthoDB_count_0.3_1	535	0	130	167397	535	0	130	10507	535	665	0.8045112781954887	430.4135338345865
PANTHER_count_0.3_1e-30	491	166	12	167393	491	166	12	10508	657	669	0.9820627802690582	645.2152466367712
PANTHER_count_0.3_1e-20	671	212	21	167158	671	212	21	10506	883	904	0.9767699115044248	862.4878318584072
PANTHER_count_0.3_1e-15	752	236	24	167050	752	236	24	10506	988	1012	0.9762845849802372	964.5691699604744
PANTHER_count_0.3_1e-10	837	265	29	166931	837	265	29	10506	1102	1131	0.9743589743589743	1073.7435897435896
PANTHER_count_0.3_1e-05	878	282	34	166868	878	282	34	10506	1160	1194	0.9715242881072027	1126.9681742043551
PANTHER_count_0.3_0.01	889	286	35	166852	889	286	35	10506	1175	1210	0.9710743801652892	1141.0123966942149
PANTHER_count_0.3_1	890	287	35	166850	890	287	35	10506	1177	1212	0.9711221122112211	1143.0107260726072
InterPro_count_0.3_1e-30	398	272	0	167392	398	272	0	10508	670	670	1.0	670.0
InterPro_count_0.3_1e-20	563	341	1	167157	563	341	1	10506	904	905	0.9988950276243094	903.0011049723756
InterPro_count_0.3_1e-15	631	382	1	167048	631	382	1	10506	1013	1014	0.9990138067061144	1012.0009861932939
InterPro_count_0.3_1e-10	715	419	2	166926	715	419	2	10506	1134	1136	0.9982394366197183	1132.0035211267605
InterPro_count_0.3_1e-05	764	439	2	166857	764	439	2	10506	1203	1205	0.9983402489626556	1201.0033195020746
InterPro_count_0.3_0.01	782	442	2	166836	782	442	2	10506	1224	1226	0.99836867862969	1222.0032626427405
InterPro_count_0.3_1	786	442	3	166831	786	442	3	10504	1228	1231	0.9975629569455727	1225.0073111291633
Pfam_count_0.3_1e-30	540	115	9	167398	540	115	9	10508	655	664	0.9864457831325302	646.1219879518072
Pfam_count_0.3_1e-20	747	135	13	167167	747	135	13	10506	882	895	0.9854748603351955	869.1888268156424
Pfam_count_0.3_1e-15	842	145	14	167061	842	145	14	10506	987	1001	0.986013986013986	973.1958041958043
Pfam_count_0.3_1e-10	948	154	14	166946	948	154	14	10506	1102	1116	0.9874551971326165	1088.1756272401435
Pfam_count_0.3_1e-05	1008	159	15	166880	1008	159	15	10506	1167	1182	0.9873096446700508	1152.1903553299492
Pfam_count_0.3_0.01	1028	159	15	166860	1028	159	15	10506	1187	1202	0.9875207986688852	1172.1871880199667
Pfam_count_0.3_1	1031	159	16	166856	1031	159	16	10505	1190	1206	0.9867330016583747	1174.212271973466
eggNOG_count_0.3_1e-30	236	5	9	167812	236	5	9	10508	241	250	0.964	232.32399999999998
eggNOG_count_0.3_1e-20	323	9	15	167715	323	9	15	10507	332	347	0.9567723342939481	317.64841498559076
eggNOG_count_0.3_1e-15	370	10	17	167665	370	10	17	10507	380	397	0.9571788413098237	363.727959697733
eggNOG_count_0.3_1e-10	414	10	20	167618	414	10	20	10507	424	444	0.954954954954955	404.9009009009009
eggNOG_count_0.3_1e-05	439	11	26	167586	439	11	26	10507	450	476	0.9453781512605042	425.4201680672269
eggNOG_count_0.3_0.01	441	11	31	167579	441	11	31	10507	452	483	0.9358178053830227	422.9896480331263
eggNOG_count_0.3_1	442	11	31	167578	442	11	31	10507	453	484	0.9359504132231405	423.98553719008265
EC number_count_0.35_1e-30	185	3	24	167850	185	3	24	10508	188	212	0.8867924528301887	166.7169811320755
EC number_count_0.35_1e-20	207	3	31	167821	207	3	31	10508	210	241	0.8713692946058091	182.9875518672199
EC number_count_0.35_1e-15	214	3	31	167814	214	3	31	10508	217	248	0.875	189.875
EC number_count_0.35_1e-10	221	3	32	167806	221	3	32	10508	224	256	0.875	196.0
EC number_count_0.35_1e-05	222	3	32	167805	222	3	32	10508	225	257	0.8754863813229572	196.98443579766536
EC number_count_0.35_0.01	222	3	32	167805	222	3	32	10508	225	257	0.8754863813229572	196.98443579766536
EC number_count_0.35_1	222	3	32	167805	222	3	32	10508	225	257	0.8754863813229572	196.98443579766536
Protein families_count_0.35_1e-30	334	2	29	167697	334	2	29	10508	336	365	0.9205479452054794	309.3041095890411
Protein families_count_0.35_1e-20	430	2	34	167596	430	2	34	10507	432	466	0.927038626609442	400.48068669527896
Protein families_count_0.35_1e-15	478	2	34	167548	478	2	34	10507	480	514	0.933852140077821	448.2490272373541
Protein families_count_0.35_1e-10	528	2	35	167497	528	2	35	10507	530	565	0.9380530973451328	497.16814159292034
Protein families_count_0.35_1e-05	555	2	36	167469	555	2	36	10507	557	593	0.93929173693086	523.185497470489
Protein families_count_0.35_0.01	563	2	36	167461	563	2	36	10507	565	601	0.940099833610649	531.1564059900167
Protein families_count_0.35_1	564	2	36	167460	564	2	36	10507	566	602	0.9401993355481728	532.1528239202659
OrthoDB_count_0.35_1e-30	213	0	43	167806	213	0	43	10508	213	256	0.83203125	177.22265625
OrthoDB_count_0.35_1e-20	285	0	55	167722	285	0	55	10508	285	340	0.8382352941176471	238.89705882352942
OrthoDB_count_0.35_1e-15	324	0	61	167677	324	0	61	10508	324	385	0.8415584415584415	272.66493506493504
OrthoDB_count_0.35_1e-10	362	0	75	167625	362	0	75	10508	362	437	0.8283752860411899	299.87185354691076
OrthoDB_count_0.35_1e-05	378	0	81	167603	378	0	81	10508	378	459	0.8235294117647058	311.2941176470588
OrthoDB_count_0.35_0.01	385	0	82	167595	385	0	82	10508	385	467	0.8244111349036403	317.3982869379015
OrthoDB_count_0.35_1	386	0	82	167594	386	0	82	10508	386	468	0.8247863247863247	318.36752136752136
PANTHER_count_0.35_1e-30	390	120	8	167544	390	120	8	10508	510	518	0.9845559845559846	502.12355212355214
PANTHER_count_0.35_1e-20	513	141	12	167396	513	141	12	10507	654	666	0.9819819819819819	642.2162162162161
PANTHER_count_0.35_1e-15	567	153	14	167328	567	153	14	10507	720	734	0.9809264305177112	706.2670299727521
PANTHER_count_0.35_1e-10	626	171	17	167248	626	171	17	10507	797	814	0.9791154791154791	780.3550368550369
PANTHER_count_0.35_1e-05	653	181	19	167209	653	181	19	10507	834	853	0.977725674091442	815.4232121922626
PANTHER_count_0.35_0.01	659	185	19	167199	659	185	19	10507	844	863	0.9779837775202781	825.4183082271147
PANTHER_count_0.35_1	659	186	19	167198	659	186	19	10507	845	864	0.9780092592592593	826.4178240740741
InterPro_count_0.35_1e-30	325	194	0	167543	325	194	0	10508	519	519	1.0	519.0
InterPro_count_0.35_1e-20	439	227	1	167395	439	227	1	10507	666	667	0.9985007496251874	665.0014992503749
InterPro_count_0.35_1e-15	485	250	1	167326	485	250	1	10507	735	736	0.998641304347826	734.0013586956521
InterPro_count_0.35_1e-10	542	273	1	167246	542	273	1	10507	815	816	0.9987745098039216	814.0012254901961
InterPro_count_0.35_1e-05	573	285	1	167203	573	285	1	10507	858	859	0.9988358556461001	857.0011641443539
InterPro_count_0.35_0.01	585	285	1	167191	585	285	1	10507	870	871	0.9988518943742825	869.0011481056257
InterPro_count_0.35_1	587	285	1	167189	587	285	1	10506	872	873	0.9988545246277205	871.0011454753723
Pfam_count_0.35_1e-30	429	79	6	167548	429	79	6	10508	508	514	0.9883268482490273	502.07003891050584
Pfam_count_0.35_1e-20	563	88	9	167402	563	88	9	10507	651	660	0.9863636363636363	642.1227272727273
Pfam_count_0.35_1e-15	625	94	10	167333	625	94	10	10507	719	729	0.9862825788751715	709.1371742112483
Pfam_count_0.35_1e-10	700	98	10	167254	700	98	10	10507	798	808	0.9876237623762376	788.1237623762377
Pfam_count_0.35_1e-05	738	100	11	167213	738	100	11	10507	838	849	0.9870435806831567	827.1425206124853
Pfam_count_0.35_0.01	749	100	11	167202	749	100	11	10507	849	860	0.9872093023255814	838.1406976744186
Pfam_count_0.35_1	750	100	11	167201	750	100	11	10507	850	861	0.9872241579558653	839.1405342624855
eggNOG_count_0.35_1e-30	180	4	6	167872	180	4	6	10508	184	190	0.968421052631579	178.18947368421053
eggNOG_count_0.35_1e-20	236	7	11	167808	236	7	11	10508	243	254	0.9566929133858267	232.4763779527559
eggNOG_count_0.35_1e-15	269	7	13	167773	269	7	13	10508	276	289	0.9550173010380623	263.5847750865052
eggNOG_count_0.35_1e-10	296	7	14	167745	296	7	14	10508	303	317	0.9558359621451105	289.61829652996846
eggNOG_count_0.35_1e-05	316	7	17	167722	316	7	17	10508	323	340	0.95	306.84999999999997
eggNOG_count_0.35_0.01	318	7	20	167717	318	7	20	10508	325	345	0.9420289855072463	306.15942028985506
eggNOG_count_0.35_1	319	7	20	167716	319	7	20	10508	326	346	0.9421965317919075	307.15606936416185
EC number_count_0.4_1e-30	144	2	17	167899	144	2	17	10508	146	163	0.8957055214723927	130.77300613496934
EC number_count_0.4_1e-20	160	2	20	167880	160	2	20	10508	162	182	0.8901098901098901	144.1978021978022
EC number_count_0.4_1e-15	162	2	20	167878	162	2	20	10508	164	184	0.8913043478260869	146.17391304347825
EC number_count_0.4_1e-10	164	2	21	167875	164	2	21	10508	166	187	0.8877005347593583	147.35828877005346
EC number_count_0.4_1e-05	164	2	21	167875	164	2	21	10508	166	187	0.8877005347593583	147.35828877005346
EC number_count_0.4_0.01	164	2	21	167875	164	2	21	10508	166	187	0.8877005347593583	147.35828877005346
EC number_count_0.4_1	164	2	21	167875	164	2	21	10508	166	187	0.8877005347593583	147.35828877005346
Protein families_count_0.4_1e-30	247	2	24	167789	247	2	24	10508	249	273	0.9120879120879121	227.1098901098901
Protein families_count_0.4_1e-20	314	2	27	167719	314	2	27	10508	316	343	0.9212827988338192	291.1253644314869
Protein families_count_0.4_1e-15	352	2	27	167681	352	2	27	10508	354	381	0.9291338582677166	328.9133858267717
Protein families_count_0.4_1e-10	377	2	27	167656	377	2	27	10508	379	406	0.9334975369458128	353.7955665024631
Protein families_count_0.4_1e-05	395	2	28	167637	395	2	28	10508	397	425	0.9341176470588235	370.8447058823529
Protein families_count_0.4_0.01	400	2	28	167632	400	2	28	10508	402	430	0.9348837209302325	375.8232558139535
Protein families_count_0.4_1	401	2	28	167631	401	2	28	10508	403	431	0.9350348027842227	376.8190255220417
OrthoDB_count_0.4_1e-30	149	0	30	167883	149	0	30	10508	149	179	0.8324022346368715	124.02793296089385
OrthoDB_count_0.4_1e-20	197	0	37	167828	197	0	37	10508	197	234	0.8418803418803419	165.85042735042734
OrthoDB_count_0.4_1e-15	223	0	42	167797	223	0	42	10508	223	265	0.8415094339622642	187.65660377358492
OrthoDB_count_0.4_1e-10	238	0	48	167776	238	0	48	10508	238	286	0.8321678321678322	198.05594405594405
OrthoDB_count_0.4_1e-05	247	0	50	167765	247	0	50	10508	247	297	0.8316498316498316	205.4175084175084
OrthoDB_count_0.4_0.01	251	0	51	167760	251	0	51	10508	251	302	0.8311258278145696	208.61258278145695
OrthoDB_count_0.4_1	252	0	51	167759	252	0	51	10508	252	303	0.8316831683168316	209.58415841584159
PANTHER_count_0.4_1e-30	292	78	2	167690	292	78	2	10508	370	372	0.9946236559139785	368.01075268817203
PANTHER_count_0.4_1e-20	370	91	6	167595	370	91	6	10508	461	467	0.987152034261242	455.07708779443254
PANTHER_count_0.4_1e-15	407	99	7	167549	407	99	7	10508	506	513	0.98635477582846	499.09551656920075
PANTHER_count_0.4_1e-10	436	107	8	167511	436	107	8	10508	543	551	0.985480943738657	535.1161524500908
PANTHER_count_0.4_1e-05	449	115	9	167489	449	115	9	10508	564	573	0.9842931937172775	555.1413612565445
PANTHER_count_0.4_0.01	452	118	9	167483	452	118	9	10508	570	579	0.9844559585492227	561.139896373057
PANTHER_count_0.4_1	452	119	9	167482	452	119	9	10508	571	580	0.9844827586206897	562.1396551724138
InterPro_count_0.4_1e-30	244	129	0	167689	244	129	0	10508	373	373	1.0	373.0
InterPro_count_0.4_1e-20	319	149	0	167594	319	149	0	10508	468	468	1.0	468.0
InterPro_count_0.4_1e-15	350	165	0	167547	350	165	0	10508	515	515	1.0	515.0
InterPro_count_0.4_1e-10	375	178	0	167509	375	178	0	10508	553	553	1.0	553.0
InterPro_count_0.4_1e-05	392	186	0	167484	392	186	0	10508	578	578	1.0	578.0
InterPro_count_0.4_0.01	399	186	0	167477	399	186	0	10508	585	585	1.0	585.0
InterPro_count_0.4_1	400	186	0	167476	400	186	0	10508	586	586	1.0	586.0
Pfam_count_0.4_1e-30	314	52	4	167692	314	52	4	10508	366	370	0.9891891891891892	362.04324324324324
Pfam_count_0.4_1e-20	403	55	5	167599	403	55	5	10508	458	463	0.9892008639308856	453.0539956803456
Pfam_count_0.4_1e-15	446	59	5	167552	446	59	5	10508	505	510	0.9901960784313726	500.04901960784315
Pfam_count_0.4_1e-10	481	61	5	167515	481	61	5	10508	542	547	0.9908592321755028	537.0457038391224
Pfam_count_0.4_1e-05	503	62	5	167492	503	62	5	10508	565	570	0.9912280701754386	560.0438596491227
Pfam_count_0.4_0.01	509	62	5	167486	509	62	5	10508	571	576	0.9913194444444444	566.0434027777777
Pfam_count_0.4_1	510	62	5	167485	510	62	5	10508	572	577	0.9913344887348353	567.0433275563258
eggNOG_count_0.4_1e-30	120	2	4	167936	120	2	4	10508	122	126	0.9682539682539683	118.12698412698413
eggNOG_count_0.4_1e-20	157	2	5	167898	157	2	5	10508	159	164	0.9695121951219512	154.15243902439025
eggNOG_count_0.4_1e-15	179	2	6	167875	179	2	6	10508	181	187	0.9679144385026738	175.19251336898395
eggNOG_count_0.4_1e-10	193	2	6	167861	193	2	6	10508	195	201	0.9701492537313433	189.17910447761196
eggNOG_count_0.4_1e-05	206	2	7	167847	206	2	7	10508	208	215	0.9674418604651163	201.22790697674418
eggNOG_count_0.4_0.01	207	2	10	167843	207	2	10	10508	209	219	0.954337899543379	199.45662100456622
eggNOG_count_0.4_1	208	2	10	167842	208	2	10	10508	210	220	0.9545454545454546	200.45454545454547
EC number_count_0.45_1e-30	107	1	11	167943	107	1	11	10508	108	119	0.907563025210084	98.01680672268907
EC number_count_0.45_1e-20	115	1	14	167932	115	1	14	10508	116	130	0.8923076923076924	103.50769230769231
EC number_count_0.45_1e-15	116	1	14	167931	116	1	14	10508	117	131	0.8931297709923665	104.49618320610688
EC number_count_0.45_1e-10	118	1	14	167929	118	1	14	10508	119	133	0.8947368421052632	106.47368421052632
EC number_count_0.45_1e-05	118	1	14	167929	118	1	14	10508	119	133	0.8947368421052632	106.47368421052632
EC number_count_0.45_0.01	118	1	14	167929	118	1	14	10508	119	133	0.8947368421052632	106.47368421052632
EC number_count_0.45_1	118	1	14	167929	118	1	14	10508	119	133	0.8947368421052632	106.47368421052632
Protein families_count_0.45_1e-30	179	1	17	167865	179	1	17	10508	180	197	0.9137055837563451	164.46700507614213
Protein families_count_0.45_1e-20	223	1	20	167818	223	1	20	10508	224	244	0.9180327868852459	205.63934426229508
Protein families_count_0.45_1e-15	248	1	20	167793	248	1	20	10508	249	269	0.9256505576208178	230.48698884758363
Protein families_count_0.45_1e-10	262	1	20	167779	262	1	20	10508	263	283	0.9293286219081273	244.41342756183747
Protein families_count_0.45_1e-05	277	1	20	167764	277	1	20	10508	278	298	0.9328859060402684	259.3422818791946
Protein families_count_0.45_0.01	279	1	20	167762	279	1	20	10508	280	300	0.9333333333333333	261.3333333333333
Protein families_count_0.45_1	279	1	20	167762	279	1	20	10508	280	300	0.9333333333333333	261.3333333333333
OrthoDB_count_0.45_1e-30	102	0	25	167935	102	0	25	10508	102	127	0.8031496062992126	81.92125984251969
OrthoDB_count_0.45_1e-20	135	0	31	167896	135	0	31	10508	135	166	0.8132530120481928	109.78915662650603
OrthoDB_count_0.45_1e-15	153	0	35	167874	153	0	35	10508	153	188	0.8138297872340425	124.51595744680851
OrthoDB_count_0.45_1e-10	159	0	38	167865	159	0	38	10508	159	197	0.8071065989847716	128.32994923857868
OrthoDB_count_0.45_1e-05	167	0	38	167857	167	0	38	10508	167	205	0.8146341463414634	136.04390243902438
OrthoDB_count_0.45_0.01	168	0	38	167856	168	0	38	10508	168	206	0.8155339805825242	137.00970873786406
OrthoDB_count_0.45_1	168	0	38	167856	168	0	38	10508	168	206	0.8155339805825242	137.00970873786406
PANTHER_count_0.45_1e-30	211	52	0	167799	211	52	0	10508	263	263	1.0	263.0
PANTHER_count_0.45_1e-20	263	62	1	167736	263	62	1	10508	325	326	0.9969325153374233	324.0030674846626
PANTHER_count_0.45_1e-15	284	69	2	167707	284	69	2	10508	353	355	0.9943661971830986	351.0112676056338
PANTHER_count_0.45_1e-10	298	73	3	167688	298	73	3	10508	371	374	0.9919786096256684	368.024064171123
PANTHER_count_0.45_1e-05	310	77	3	167672	310	77	3	10508	387	390	0.9923076923076923	384.0230769230769
PANTHER_count_0.45_0.01	311	78	3	167670	311	78	3	10508	389	392	0.9923469387755102	386.02295918367344
PANTHER_count_0.45_1	311	78	3	167670	311	78	3	10508	389	392	0.9923469387755102	386.02295918367344
InterPro_count_0.45_1e-30	184	80	0	167798	184	80	0	10508	264	264	1.0	264.0
InterPro_count_0.45_1e-20	236	91	0	167735	236	91	0	10508	327	327	1.0	327.0
InterPro_count_0.45_1e-15	255	102	0	167705	255	102	0	10508	357	357	1.0	357.0
InterPro_count_0.45_1e-10	265	111	0	167686	265	111	0	10508	376	376	1.0	376.0
InterPro_count_0.45_1e-05	278	116	0	167668	278	116	0	10508	394	394	1.0	394.0
InterPro_count_0.45_0.01	281	116	0	167665	281	116	0	10508	397	397	1.0	397.0
InterPro_count_0.45_1	281	116	0	167665	281	116	0	10508	397	397	1.0	397.0
Pfam_count_0.45_1e-30	230	27	4	167801	230	27	4	10508	257	261	0.9846743295019157	253.06130268199234
Pfam_count_0.45_1e-20	291	27	5	167739	291	27	5	10508	318	323	0.9845201238390093	313.077399380805
Pfam_count_0.45_1e-15	319	29	5	167709	319	29	5	10508	348	353	0.9858356940509915	343.07082152974505
Pfam_count_0.45_1e-10	335	31	5	167691	335	31	5	10508	366	371	0.9865229110512129	361.06738544474393
Pfam_count_0.45_1e-05	352	32	5	167673	352	32	5	10508	384	389	0.987146529562982	379.0642673521851
Pfam_count_0.45_0.01	355	32	5	167670	355	32	5	10508	387	392	0.9872448979591837	382.0637755102041
Pfam_count_0.45_1	355	32	5	167670	355	32	5	10508	387	392	0.9872448979591837	382.0637755102041
eggNOG_count_0.45_1e-30	80	1	3	167978	80	1	3	10508	81	84	0.9642857142857143	78.10714285714286
eggNOG_count_0.45_1e-20	104	1	4	167953	104	1	4	10508	105	109	0.963302752293578	101.14678899082568
eggNOG_count_0.45_1e-15	117	1	5	167939	117	1	5	10508	118	123	0.959349593495935	113.20325203252033
eggNOG_count_0.45_1e-10	125	1	5	167931	125	1	5	10508	126	131	0.9618320610687023	121.19083969465649
eggNOG_count_0.45_1e-05	135	1	6	167920	135	1	6	10508	136	142	0.9577464788732394	130.25352112676055
eggNOG_count_0.45_0.01	136	1	6	167919	136	1	6	10508	137	143	0.958041958041958	131.25174825174824
eggNOG_count_0.45_1	136	1	6	167919	136	1	6	10508	137	143	0.958041958041958	131.25174825174824
EC number_count_0.5_1e-30	72	1	8	167981	72	1	8	10508	73	81	0.9012345679012346	65.79012345679013
EC number_count_0.5_1e-20	75	1	8	167978	75	1	8	10508	76	84	0.9047619047619048	68.76190476190476
EC number_count_0.5_1e-15	75	1	8	167978	75	1	8	10508	76	84	0.9047619047619048	68.76190476190476
EC number_count_0.5_1e-10	77	1	8	167976	77	1	8	10508	78	86	0.9069767441860465	70.74418604651163
EC number_count_0.5_1e-05	77	1	8	167976	77	1	8	10508	78	86	0.9069767441860465	70.74418604651163
EC number_count_0.5_0.01	77	1	8	167976	77	1	8	10508	78	86	0.9069767441860465	70.74418604651163
EC number_count_0.5_1	77	1	8	167976	77	1	8	10508	78	86	0.9069767441860465	70.74418604651163
Protein families_count_0.5_1e-30	126	0	8	167928	126	0	8	10508	126	134	0.9402985074626866	118.47761194029852
Protein families_count_0.5_1e-20	158	0	9	167895	158	0	9	10508	158	167	0.9461077844311377	149.48502994011977
Protein families_count_0.5_1e-15	173	0	9	167880	173	0	9	10508	173	182	0.9505494505494505	164.44505494505495
Protein families_count_0.5_1e-10	180	0	9	167873	180	0	9	10508	180	189	0.9523809523809523	171.42857142857142
Protein families_count_0.5_1e-05	191	0	9	167862	191	0	9	10508	191	200	0.955	182.405
Protein families_count_0.5_0.01	193	0	9	167860	193	0	9	10508	193	202	0.9554455445544554	184.4009900990099
Protein families_count_0.5_1	193	0	9	167860	193	0	9	10508	193	202	0.9554455445544554	184.4009900990099
OrthoDB_count_0.5_1e-30	68	0	16	167978	68	0	16	10508	68	84	0.8095238095238095	55.04761904761905
OrthoDB_count_0.5_1e-20	92	0	18	167952	92	0	18	10508	92	110	0.8363636363636363	76.94545454545454
OrthoDB_count_0.5_1e-15	100	0	20	167942	100	0	20	10508	100	120	0.8333333333333334	83.33333333333334
OrthoDB_count_0.5_1e-10	104	0	23	167935	104	0	23	10508	104	127	0.8188976377952756	85.16535433070867
OrthoDB_count_0.5_1e-05	108	0	23	167931	108	0	23	10508	108	131	0.8244274809160306	89.03816793893131
OrthoDB_count_0.5_0.01	109	0	23	167930	109	0	23	10508	109	132	0.8257575757575758	90.00757575757576
OrthoDB_count_0.5_1	109	0	23	167930	109	0	23	10508	109	132	0.8257575757575758	90.00757575757576
PANTHER_count_0.5_1e-30	136	36	0	167890	136	36	0	10508	172	172	1.0	172.0
PANTHER_count_0.5_1e-20	167	45	1	167849	167	45	1	10508	212	213	0.9953051643192489	211.00469483568077
PANTHER_count_0.5_1e-15	177	51	1	167833	177	51	1	10508	228	229	0.9956331877729258	227.00436681222706
PANTHER_count_0.5_1e-10	184	53	1	167824	184	53	1	10508	237	238	0.9957983193277311	236.00420168067228
PANTHER_count_0.5_1e-05	194	54	1	167813	194	54	1	10508	248	249	0.9959839357429718	247.00401606425703
PANTHER_count_0.5_0.01	195	55	1	167811	195	55	1	10508	250	251	0.9960159362549801	249.003984063745
PANTHER_count_0.5_1	195	55	1	167811	195	55	1	10508	250	251	0.9960159362549801	249.003984063745
InterPro_count_0.5_1e-30	138	35	0	167889	138	35	0	10508	173	173	1.0	173.0
InterPro_count_0.5_1e-20	171	43	0	167848	171	43	0	10508	214	214	1.0	214.0
InterPro_count_0.5_1e-15	181	49	0	167832	181	49	0	10508	230	230	1.0	230.0
InterPro_count_0.5_1e-10	188	51	0	167823	188	51	0	10508	239	239	1.0	239.0
InterPro_count_0.5_1e-05	198	52	0	167812	198	52	0	10508	250	250	1.0	250.0
InterPro_count_0.5_0.01	201	52	0	167809	201	52	0	10508	253	253	1.0	253.0
InterPro_count_0.5_1	201	52	0	167809	201	52	0	10508	253	253	1.0	253.0
Pfam_count_0.5_1e-30	158	11	1	167892	158	11	1	10508	169	170	0.9941176470588236	168.00588235294117
Pfam_count_0.5_1e-20	198	11	2	167851	198	11	2	10508	209	211	0.990521327014218	207.01895734597156
Pfam_count_0.5_1e-15	213	12	2	167835	213	12	2	10508	225	227	0.9911894273127754	223.01762114537445
Pfam_count_0.5_1e-10	221	12	2	167827	221	12	2	10508	233	235	0.9914893617021276	231.01702127659576
Pfam_count_0.5_1e-05	232	12	2	167816	232	12	2	10508	244	246	0.991869918699187	242.0162601626016
Pfam_count_0.5_0.01	235	12	2	167813	235	12	2	10508	247	249	0.9919678714859438	245.01606425702812
Pfam_count_0.5_1	235	12	2	167813	235	12	2	10508	247	249	0.9919678714859438	245.01606425702812
eggNOG_count_0.5_1e-30	53	0	2	168007	53	0	2	10508	53	55	0.9636363636363636	51.07272727272727
eggNOG_count_0.5_1e-20	70	0	2	167990	70	0	2	10508	70	72	0.9722222222222222	68.05555555555556
eggNOG_count_0.5_1e-15	79	0	2	167981	79	0	2	10508	79	81	0.9753086419753086	77.04938271604938
eggNOG_count_0.5_1e-10	84	0	2	167976	84	0	2	10508	84	86	0.9767441860465116	82.04651162790697
eggNOG_count_0.5_1e-05	89	0	3	167970	89	0	3	10508	89	92	0.967391304347826	86.09782608695652
eggNOG_count_0.5_0.01	90	0	3	167969	90	0	3	10508	90	93	0.967741935483871	87.09677419354838
eggNOG_count_0.5_1	90	0	3	167969	90	0	3	10508	90	93	0.967741935483871	87.09677419354838
EC number_count_0.55_1e-30	39	0	7	168016	39	0	7	10508	39	46	0.8478260869565217	33.065217391304344
EC number_count_0.55_1e-20	40	0	7	168015	40	0	7	10508	40	47	0.851063829787234	34.04255319148936
EC number_count_0.55_1e-15	40	0	7	168015	40	0	7	10508	40	47	0.851063829787234	34.04255319148936
EC number_count_0.55_1e-10	40	0	7	168015	40	0	7	10508	40	47	0.851063829787234	34.04255319148936
EC number_count_0.55_1e-05	40	0	7	168015	40	0	7	10508	40	47	0.851063829787234	34.04255319148936
EC number_count_0.55_0.01	40	0	7	168015	40	0	7	10508	40	47	0.851063829787234	34.04255319148936
EC number_count_0.55_1	40	0	7	168015	40	0	7	10508	40	47	0.851063829787234	34.04255319148936
Protein families_count_0.55_1e-30	75	0	7	167980	75	0	7	10508	75	82	0.9146341463414634	68.59756097560975
Protein families_count_0.55_1e-20	92	0	8	167962	92	0	8	10508	92	100	0.92	84.64
Protein families_count_0.55_1e-15	100	0	8	167954	100	0	8	10508	100	108	0.9259259259259259	92.5925925925926
Protein families_count_0.55_1e-10	105	0	8	167949	105	0	8	10508	105	113	0.9292035398230089	97.56637168141593
Protein families_count_0.55_1e-05	110	0	8	167944	110	0	8	10508	110	118	0.9322033898305084	102.54237288135593
Protein families_count_0.55_0.01	111	0	8	167943	111	0	8	10508	111	119	0.9327731092436975	103.53781512605042
Protein families_count_0.55_1	111	0	8	167943	111	0	8	10508	111	119	0.9327731092436975	103.53781512605042
OrthoDB_count_0.55_1e-30	38	0	13	168011	38	0	13	10508	38	51	0.7450980392156863	28.313725490196077
OrthoDB_count_0.55_1e-20	53	0	13	167996	53	0	13	10508	53	66	0.803030303030303	42.560606060606055
OrthoDB_count_0.55_1e-15	56	0	15	167991	56	0	15	10508	56	71	0.7887323943661971	44.16901408450704
OrthoDB_count_0.55_1e-10	59	0	16	167987	59	0	16	10508	59	75	0.7866666666666666	46.413333333333334
OrthoDB_count_0.55_1e-05	61	0	16	167985	61	0	16	10508	61	77	0.7922077922077922	48.324675324675326
OrthoDB_count_0.55_0.01	61	0	16	167985	61	0	16	10508	61	77	0.7922077922077922	48.324675324675326
OrthoDB_count_0.55_1	61	0	16	167985	61	0	16	10508	61	77	0.7922077922077922	48.324675324675326
PANTHER_count_0.55_1e-30	82	23	0	167957	82	23	0	10508	105	105	1.0	105.0
PANTHER_count_0.55_1e-20	99	28	1	167934	99	28	1	10508	127	128	0.9921875	126.0078125
PANTHER_count_0.55_1e-15	102	33	1	167926	102	33	1	10508	135	136	0.9926470588235294	134.00735294117646
PANTHER_count_0.55_1e-10	105	35	1	167921	105	35	1	10508	140	141	0.9929078014184397	139.00709219858155
PANTHER_count_0.55_1e-05	110	35	1	167916	110	35	1	10508	145	146	0.9931506849315068	144.00684931506848
PANTHER_count_0.55_0.01	111	35	1	167915	111	35	1	10508	146	147	0.9931972789115646	145.00680272108843
PANTHER_count_0.55_1	111	35	1	167915	111	35	1	10508	146	147	0.9931972789115646	145.00680272108843
InterPro_count_0.55_1e-30	86	20	0	167956	86	20	0	10508	106	106	1.0	106.0
InterPro_count_0.55_1e-20	103	26	0	167933	103	26	0	10508	129	129	1.0	129.0
InterPro_count_0.55_1e-15	109	28	0	167925	109	28	0	10508	137	137	1.0	137.0
InterPro_count_0.55_1e-10	112	30	0	167920	112	30	0	10508	142	142	1.0	142.0
InterPro_count_0.55_1e-05	117	30	0	167915	117	30	0	10508	147	147	1.0	147.0
InterPro_count_0.55_0.01	118	30	0	167914	118	30	0	10508	148	148	1.0	148.0
InterPro_count_0.55_1	118	30	0	167914	118	30	0	10508	148	148	1.0	148.0
Pfam_count_0.55_1e-30	96	8	1	167957	96	8	1	10508	104	105	0.9904761904761905	103.00952380952381
Pfam_count_0.55_1e-20	119	8	1	167934	119	8	1	10508	127	128	0.9921875	126.0078125
Pfam_count_0.55_1e-15	126	9	1	167926	126	9	1	10508	135	136	0.9926470588235294	134.00735294117646
Pfam_count_0.55_1e-10	130	9	1	167922	130	9	1	10508	139	140	0.9928571428571429	138.00714285714287
Pfam_count_0.55_1e-05	135	9	1	167917	135	9	1	10508	144	145	0.993103448275862	143.00689655172414
Pfam_count_0.55_0.01	136	9	1	167916	136	9	1	10508	145	146	0.9931506849315068	144.00684931506848
Pfam_count_0.55_1	136	9	1	167916	136	9	1	10508	145	146	0.9931506849315068	144.00684931506848
eggNOG_count_0.55_1e-30	32	0	2	168028	32	0	2	10508	32	34	0.9411764705882353	30.11764705882353
eggNOG_count_0.55_1e-20	39	0	2	168021	39	0	2	10508	39	41	0.9512195121951219	37.09756097560975
eggNOG_count_0.55_1e-15	44	0	2	168016	44	0	2	10508	44	46	0.9565217391304348	42.08695652173913
eggNOG_count_0.55_1e-10	46	0	2	168014	46	0	2	10508	46	48	0.9583333333333334	44.083333333333336
eggNOG_count_0.55_1e-05	49	0	2	168011	49	0	2	10508	49	51	0.9607843137254902	47.07843137254902
eggNOG_count_0.55_0.01	49	0	2	168011	49	0	2	10508	49	51	0.9607843137254902	47.07843137254902
eggNOG_count_0.55_1	49	0	2	168011	49	0	2	10508	49	51	0.9607843137254902	47.07843137254902
EC number_count_0.6_1e-30	23	0	3	168036	23	0	3	10508	23	26	0.8846153846153846	20.346153846153847
EC number_count_0.6_1e-20	24	0	3	168035	24	0	3	10508	24	27	0.8888888888888888	21.333333333333332
EC number_count_0.6_1e-15	24	0	3	168035	24	0	3	10508	24	27	0.8888888888888888	21.333333333333332
EC number_count_0.6_1e-10	24	0	3	168035	24	0	3	10508	24	27	0.8888888888888888	21.333333333333332
EC number_count_0.6_1e-05	24	0	3	168035	24	0	3	10508	24	27	0.8888888888888888	21.333333333333332
EC number_count_0.6_0.01	24	0	3	168035	24	0	3	10508	24	27	0.8888888888888888	21.333333333333332
EC number_count_0.6_1	24	0	3	168035	24	0	3	10508	24	27	0.8888888888888888	21.333333333333332
Protein families_count_0.6_1e-30	47	0	6	168009	47	0	6	10508	47	53	0.8867924528301887	41.67924528301887
Protein families_count_0.6_1e-20	61	0	7	167994	61	0	7	10508	61	68	0.8970588235294118	54.72058823529412
Protein families_count_0.6_1e-15	66	0	7	167989	66	0	7	10508	66	73	0.9041095890410958	59.671232876712324
Protein families_count_0.6_1e-10	68	0	7	167987	68	0	7	10508	68	75	0.9066666666666666	61.65333333333333
Protein families_count_0.6_1e-05	72	0	7	167983	72	0	7	10508	72	79	0.9113924050632911	65.62025316455696
Protein families_count_0.6_0.01	72	0	7	167983	72	0	7	10508	72	79	0.9113924050632911	65.62025316455696
Protein families_count_0.6_1	72	0	7	167983	72	0	7	10508	72	79	0.9113924050632911	65.62025316455696
OrthoDB_count_0.6_1e-30	25	0	10	168027	25	0	10	10508	25	35	0.7142857142857143	17.857142857142858
OrthoDB_count_0.6_1e-20	34	0	10	168018	34	0	10	10508	34	44	0.7727272727272727	26.272727272727273
OrthoDB_count_0.6_1e-15	36	0	10	168016	36	0	10	10508	36	46	0.782608695652174	28.17391304347826
OrthoDB_count_0.6_1e-10	38	0	10	168014	38	0	10	10508	38	48	0.7916666666666666	30.083333333333332
OrthoDB_count_0.6_1e-05	39	0	10	168013	39	0	10	10508	39	49	0.7959183673469388	31.040816326530614
OrthoDB_count_0.6_0.01	39	0	10	168013	39	0	10	10508	39	49	0.7959183673469388	31.040816326530614
OrthoDB_count_0.6_1	39	0	10	168013	39	0	10	10508	39	49	0.7959183673469388	31.040816326530614
PANTHER_count_0.6_1e-30	51	17	0	167994	51	17	0	10508	68	68	1.0	68.0
PANTHER_count_0.6_1e-20	64	21	0	167977	64	21	0	10508	85	85	1.0	85.0
PANTHER_count_0.6_1e-15	66	24	0	167972	66	24	0	10508	90	90	1.0	90.0
PANTHER_count_0.6_1e-10	68	24	0	167970	68	24	0	10508	92	92	1.0	92.0
PANTHER_count_0.6_1e-05	72	24	0	167966	72	24	0	10508	96	96	1.0	96.0
PANTHER_count_0.6_0.01	72	24	0	167966	72	24	0	10508	96	96	1.0	96.0
PANTHER_count_0.6_1	72	24	0	167966	72	24	0	10508	96	96	1.0	96.0
InterPro_count_0.6_1e-30	56	12	0	167994	56	12	0	10508	68	68	1.0	68.0
InterPro_count_0.6_1e-20	69	16	0	167977	69	16	0	10508	85	85	1.0	85.0
InterPro_count_0.6_1e-15	72	18	0	167972	72	18	0	10508	90	90	1.0	90.0
InterPro_count_0.6_1e-10	74	18	0	167970	74	18	0	10508	92	92	1.0	92.0
InterPro_count_0.6_1e-05	78	18	0	167966	78	18	0	10508	96	96	1.0	96.0
InterPro_count_0.6_0.01	78	18	0	167966	78	18	0	10508	96	96	1.0	96.0
InterPro_count_0.6_1	78	18	0	167966	78	18	0	10508	96	96	1.0	96.0
Pfam_count_0.6_1e-30	61	6	1	167994	61	6	1	10508	67	68	0.9852941176470589	66.01470588235294
Pfam_count_0.6_1e-20	78	6	1	167977	78	6	1	10508	84	85	0.9882352941176471	83.01176470588236
Pfam_count_0.6_1e-15	83	6	1	167972	83	6	1	10508	89	90	0.9888888888888889	88.01111111111112
Pfam_count_0.6_1e-10	85	6	1	167970	85	6	1	10508	91	92	0.9891304347826086	90.01086956521739
Pfam_count_0.6_1e-05	89	6	1	167966	89	6	1	10508	95	96	0.9895833333333334	94.01041666666667
Pfam_count_0.6_0.01	89	6	1	167966	89	6	1	10508	95	96	0.9895833333333334	94.01041666666667
Pfam_count_0.6_1	89	6	1	167966	89	6	1	10508	95	96	0.9895833333333334	94.01041666666667
eggNOG_count_0.6_1e-30	19	0	1	168042	19	0	1	10508	19	20	0.95	18.05
eggNOG_count_0.6_1e-20	23	0	1	168038	23	0	1	10508	23	24	0.9583333333333334	22.041666666666668
eggNOG_count_0.6_1e-15	26	0	1	168035	26	0	1	10508	26	27	0.9629629629629629	25.037037037037035
eggNOG_count_0.6_1e-10	27	0	1	168034	27	0	1	10508	27	28	0.9642857142857143	26.035714285714285
eggNOG_count_0.6_1e-05	29	0	1	168032	29	0	1	10508	29	30	0.9666666666666667	28.033333333333335
eggNOG_count_0.6_0.01	29	0	1	168032	29	0	1	10508	29	30	0.9666666666666667	28.033333333333335
eggNOG_count_0.6_1	29	0	1	168032	29	0	1	10508	29	30	0.9666666666666667	28.033333333333335
EC number_count_0.65_1e-30	13	0	1	168048	13	0	1	10508	13	14	0.9285714285714286	12.071428571428571
EC number_count_0.65_1e-20	14	0	1	168047	14	0	1	10508	14	15	0.9333333333333333	13.066666666666666
EC number_count_0.65_1e-15	14	0	1	168047	14	0	1	10508	14	15	0.9333333333333333	13.066666666666666
EC number_count_0.65_1e-10	14	0	1	168047	14	0	1	10508	14	15	0.9333333333333333	13.066666666666666
EC number_count_0.65_1e-05	14	0	1	168047	14	0	1	10508	14	15	0.9333333333333333	13.066666666666666
EC number_count_0.65_0.01	14	0	1	168047	14	0	1	10508	14	15	0.9333333333333333	13.066666666666666
EC number_count_0.65_1	14	0	1	168047	14	0	1	10508	14	15	0.9333333333333333	13.066666666666666
Protein families_count_0.65_1e-30	24	0	3	168035	24	0	3	10508	24	27	0.8888888888888888	21.333333333333332
Protein families_count_0.65_1e-20	32	0	4	168026	32	0	4	10508	32	36	0.8888888888888888	28.444444444444443
Protein families_count_0.65_1e-15	36	0	4	168022	36	0	4	10508	36	40	0.9	32.4
Protein families_count_0.65_1e-10	37	0	4	168021	37	0	4	10508	37	41	0.9024390243902439	33.390243902439025
Protein families_count_0.65_1e-05	38	0	4	168020	38	0	4	10508	38	42	0.9047619047619048	34.38095238095238
Protein families_count_0.65_0.01	38	0	4	168020	38	0	4	10508	38	42	0.9047619047619048	34.38095238095238
Protein families_count_0.65_1	38	0	4	168020	38	0	4	10508	38	42	0.9047619047619048	34.38095238095238
OrthoDB_count_0.65_1e-30	13	0	4	168045	13	0	4	10508	13	17	0.7647058823529411	9.941176470588236
OrthoDB_count_0.65_1e-20	18	0	4	168040	18	0	4	10508	18	22	0.8181818181818182	14.727272727272728
OrthoDB_count_0.65_1e-15	20	0	4	168038	20	0	4	10508	20	24	0.8333333333333334	16.666666666666668
OrthoDB_count_0.65_1e-10	21	0	4	168037	21	0	4	10508	21	25	0.84	17.64
OrthoDB_count_0.65_1e-05	21	0	4	168037	21	0	4	10508	21	25	0.84	17.64
OrthoDB_count_0.65_0.01	21	0	4	168037	21	0	4	10508	21	25	0.84	17.64
OrthoDB_count_0.65_1	21	0	4	168037	21	0	4	10508	21	25	0.84	17.64
PANTHER_count_0.65_1e-30	28	8	0	168026	28	8	0	10508	36	36	1.0	36.0
PANTHER_count_0.65_1e-20	35	11	0	168016	35	11	0	10508	46	46	1.0	46.0
PANTHER_count_0.65_1e-15	36	14	0	168012	36	14	0	10508	50	50	1.0	50.0
PANTHER_count_0.65_1e-10	37	14	0	168011	37	14	0	10508	51	51	1.0	51.0
PANTHER_count_0.65_1e-05	38	14	0	168010	38	14	0	10508	52	52	1.0	52.0
PANTHER_count_0.65_0.01	38	14	0	168010	38	14	0	10508	52	52	1.0	52.0
PANTHER_count_0.65_1	38	14	0	168010	38	14	0	10508	52	52	1.0	52.0
InterPro_count_0.65_1e-30	31	5	0	168026	31	5	0	10508	36	36	1.0	36.0
InterPro_count_0.65_1e-20	39	7	0	168016	39	7	0	10508	46	46	1.0	46.0
InterPro_count_0.65_1e-15	42	8	0	168012	42	8	0	10508	50	50	1.0	50.0
InterPro_count_0.65_1e-10	43	8	0	168011	43	8	0	10508	51	51	1.0	51.0
InterPro_count_0.65_1e-05	44	8	0	168010	44	8	0	10508	52	52	1.0	52.0
InterPro_count_0.65_0.01	44	8	0	168010	44	8	0	10508	52	52	1.0	52.0
InterPro_count_0.65_1	44	8	0	168010	44	8	0	10508	52	52	1.0	52.0
Pfam_count_0.65_1e-30	32	4	0	168026	32	4	0	10508	36	36	1.0	36.0
Pfam_count_0.65_1e-20	42	4	0	168016	42	4	0	10508	46	46	1.0	46.0
Pfam_count_0.65_1e-15	46	4	0	168012	46	4	0	10508	50	50	1.0	50.0
Pfam_count_0.65_1e-10	47	4	0	168011	47	4	0	10508	51	51	1.0	51.0
Pfam_count_0.65_1e-05	48	4	0	168010	48	4	0	10508	52	52	1.0	52.0
Pfam_count_0.65_0.01	48	4	0	168010	48	4	0	10508	52	52	1.0	52.0
Pfam_count_0.65_1	48	4	0	168010	48	4	0	10508	52	52	1.0	52.0
eggNOG_count_0.65_1e-30	12	0	0	168050	12	0	0	10508	12	12	1.0	12.0
eggNOG_count_0.65_1e-20	14	0	0	168048	14	0	0	10508	14	14	1.0	14.0
eggNOG_count_0.65_1e-15	16	0	0	168046	16	0	0	10508	16	16	1.0	16.0
eggNOG_count_0.65_1e-10	16	0	0	168046	16	0	0	10508	16	16	1.0	16.0
eggNOG_count_0.65_1e-05	16	0	0	168046	16	0	0	10508	16	16	1.0	16.0
eggNOG_count_0.65_0.01	16	0	0	168046	16	0	0	10508	16	16	1.0	16.0
eggNOG_count_0.65_1	16	0	0	168046	16	0	0	10508	16	16	1.0	16.0
EC number_count_0.7_1e-30	7	0	1	168054	7	0	1	10508	7	8	0.875	6.125
EC number_count_0.7_1e-20	7	0	1	168054	7	0	1	10508	7	8	0.875	6.125
EC number_count_0.7_1e-15	7	0	1	168054	7	0	1	10508	7	8	0.875	6.125
EC number_count_0.7_1e-10	7	0	1	168054	7	0	1	10508	7	8	0.875	6.125
EC number_count_0.7_1e-05	7	0	1	168054	7	0	1	10508	7	8	0.875	6.125
EC number_count_0.7_0.01	7	0	1	168054	7	0	1	10508	7	8	0.875	6.125
EC number_count_0.7_1	7	0	1	168054	7	0	1	10508	7	8	0.875	6.125
Protein families_count_0.7_1e-30	13	0	2	168047	13	0	2	10508	13	15	0.8666666666666667	11.266666666666667
Protein families_count_0.7_1e-20	18	0	3	168041	18	0	3	10508	18	21	0.8571428571428571	15.428571428571427
Protein families_count_0.7_1e-15	19	0	3	168040	19	0	3	10508	19	22	0.8636363636363636	16.40909090909091
Protein families_count_0.7_1e-10	19	0	3	168040	19	0	3	10508	19	22	0.8636363636363636	16.40909090909091
Protein families_count_0.7_1e-05	19	0	3	168040	19	0	3	10508	19	22	0.8636363636363636	16.40909090909091
Protein families_count_0.7_0.01	19	0	3	168040	19	0	3	10508	19	22	0.8636363636363636	16.40909090909091
Protein families_count_0.7_1	19	0	3	168040	19	0	3	10508	19	22	0.8636363636363636	16.40909090909091
OrthoDB_count_0.7_1e-30	6	0	3	168053	6	0	3	10508	6	9	0.6666666666666666	4.0
OrthoDB_count_0.7_1e-20	10	0	3	168049	10	0	3	10508	10	13	0.7692307692307693	7.6923076923076925
OrthoDB_count_0.7_1e-15	10	0	3	168049	10	0	3	10508	10	13	0.7692307692307693	7.6923076923076925
OrthoDB_count_0.7_1e-10	10	0	3	168049	10	0	3	10508	10	13	0.7692307692307693	7.6923076923076925
OrthoDB_count_0.7_1e-05	10	0	3	168049	10	0	3	10508	10	13	0.7692307692307693	7.6923076923076925
OrthoDB_count_0.7_0.01	10	0	3	168049	10	0	3	10508	10	13	0.7692307692307693	7.6923076923076925
OrthoDB_count_0.7_1	10	0	3	168049	10	0	3	10508	10	13	0.7692307692307693	7.6923076923076925
PANTHER_count_0.7_1e-30	15	5	0	168042	15	5	0	10508	20	20	1.0	20.0
PANTHER_count_0.7_1e-20	19	7	0	168036	19	7	0	10508	26	26	1.0	26.0
PANTHER_count_0.7_1e-15	20	7	0	168035	20	7	0	10508	27	27	1.0	27.0
PANTHER_count_0.7_1e-10	20	7	0	168035	20	7	0	10508	27	27	1.0	27.0
PANTHER_count_0.7_1e-05	20	7	0	168035	20	7	0	10508	27	27	1.0	27.0
PANTHER_count_0.7_0.01	20	7	0	168035	20	7	0	10508	27	27	1.0	27.0
PANTHER_count_0.7_1	20	7	0	168035	20	7	0	10508	27	27	1.0	27.0
InterPro_count_0.7_1e-30	19	1	0	168042	19	1	0	10508	20	20	1.0	20.0
InterPro_count_0.7_1e-20	24	2	0	168036	24	2	0	10508	26	26	1.0	26.0
InterPro_count_0.7_1e-15	25	2	0	168035	25	2	0	10508	27	27	1.0	27.0
InterPro_count_0.7_1e-10	25	2	0	168035	25	2	0	10508	27	27	1.0	27.0
InterPro_count_0.7_1e-05	25	2	0	168035	25	2	0	10508	27	27	1.0	27.0
InterPro_count_0.7_0.01	25	2	0	168035	25	2	0	10508	27	27	1.0	27.0
InterPro_count_0.7_1	25	2	0	168035	25	2	0	10508	27	27	1.0	27.0
Pfam_count_0.7_1e-30	18	2	0	168042	18	2	0	10508	20	20	1.0	20.0
Pfam_count_0.7_1e-20	24	2	0	168036	24	2	0	10508	26	26	1.0	26.0
Pfam_count_0.7_1e-15	25	2	0	168035	25	2	0	10508	27	27	1.0	27.0
Pfam_count_0.7_1e-10	25	2	0	168035	25	2	0	10508	27	27	1.0	27.0
Pfam_count_0.7_1e-05	25	2	0	168035	25	2	0	10508	27	27	1.0	27.0
Pfam_count_0.7_0.01	25	2	0	168035	25	2	0	10508	27	27	1.0	27.0
Pfam_count_0.7_1	25	2	0	168035	25	2	0	10508	27	27	1.0	27.0
eggNOG_count_0.7_1e-30	2	0	0	168060	2	0	0	10508	2	2	1.0	2.0
eggNOG_count_0.7_1e-20	3	0	0	168059	3	0	0	10508	3	3	1.0	3.0
eggNOG_count_0.7_1e-15	3	0	0	168059	3	0	0	10508	3	3	1.0	3.0
eggNOG_count_0.7_1e-10	3	0	0	168059	3	0	0	10508	3	3	1.0	3.0
eggNOG_count_0.7_1e-05	3	0	0	168059	3	0	0	10508	3	3	1.0	3.0
eggNOG_count_0.7_0.01	3	0	0	168059	3	0	0	10508	3	3	1.0	3.0
eggNOG_count_0.7_1	3	0	0	168059	3	0	0	10508	3	3	1.0	3.0
